tetep bangga kalah menang indonesia	positive
ikuti alurnya ajamana taru timnas comeback kayak jepang kemarin malem aaminn	neutral
offside	negative
masii optimis	positive
mark klok main yokkhubner bertahan jordi	neutral
kalok jujur indonesia bener striker buas kayak bambang pamungkas boaz salosa minim striker rafael struick bagus mainya letoy body wajarlah muda ganteng	positive
salam	positive
jaga var orang thailand	neutral
pegang bola	neutral
upaya apanya jelas² nyundul bola	negative
damanik level kompetisi sekolah asia	neutral
kejutannya	negative
asnawi si anak emas sandy walsh ngerti dah mending dilepas klub asli liga teratas belgium cuman cadangan asnawi starter sekelas reece james mh peduli	negative
struick egois milih giring drpd umpan kalo diumpan goal	negative
mudah iraq golin cuman pemain kitanya kebanyakan bluder tenaga doang keluarin nedang kedepan doang pakai oper opran	negative
yann var	neutral
heran banget kiper bangkai pakek	negative
gocak gocek bae	negative
serang nih serang dongg	negative
ngapa bacot terima	negative
berharap imbang	positive
pulang	positive
harapan lolos play semangat garuda	neutral
kanan bapuk	negative
gas match terhibur permainan timnas terhibur baca komentar	neutral
asnawi suruh main garis lapangan	negative
helai rambut kena	negative
taru su serasa ad arwah maguayer masuk jiwa si	positive
tidur gabakal menang ko seri mustahil	negative
gimana var eror keputusan	negative
alloh	positive
passing berantakan bertahan kelabakan indonesia	negative
paok bener	negative
offside pas gawang wasit bunyiin pluit bola tetep jalan pas goal mh emang onsideklo offside pluit mh mgkin peluang goal hmmm	negative
nyalahin var pemian irak yng nomor offside	neutral
asmuni arhan beban timnas	neutral
var	neutral
untung aja offsidee cuyy msa bru main babak lngsung keboblan	positive
sananta masukin	positive
asnawi masoh grusak grusuk	negative
asnawi bener main ambil habis pdhl sisa palang pintu kanan msh kosong habis kali ambil habis jebol	negative
f ngehujatminimal prestasi mulut ngotorin	negative
blunder nomer punggung	neutral
fokus terganggu keputusan bodoh wasit	negative
emng bner main kaya gerobak	positive
biar keren aja mngkin	negative
nzl habis pikir demen banget perasaan blunder mulu aneh	negative
sandy maennya	neutral
sundulan keitung	neutral
target lolos grub susah bro lihat grub serem feel lolos iraq jepang	negative
iyaa emang kocak dah	positive
sandy msuk babak astaga greget asnawi mlm	neutral
dipake pajangan ka	positive
beban	negative
bagus pemain lokal kontribusinya	positive
desria sayang banget ditakutin	positive
jujur nih suka pas witan masuk langsung jleub hilang ritme	positive
var	neutral
bilangin pakai jersey merah merah masi pakai timnas prestasi kalo pakai jersey merah merah ganti jersey timnas jersey merah putih mumpung kesempatan kali pertandingan ganti jersey timnas jersey merah putih jersey merah merah	neutral
ppfftt	positive
sayuri copy biar banyakan kayak	negative
beck	negative
sann amin semoga terkabul	positive
kebobolan	negative
sty sty sty taik	positive
marc klok ivar jenner	neutral
goal murni	negative
yakob kelazzz	neutral
njing	negative
garsak grusuk jordi korbannya	negative
f sono myanmar rohingya gatau nyinyirin timnas indonesia bocah dongo goblok	negative
greget lihat rafaell tdii	positive
sandy shane masuk	positive
sekelas sandy wals pmain pengganti wkwkwkk	negative
coba main bang lawan pemain irak alah bacot doang bisanya	negative
kebanyakan gocek	negative
wasitnya sekelas wasit ep ep	negative
pelatihnya nunggu goal dlu ganti pdhl udah buntu td	negative
vidias emang var pas hongkong kmrin	neutral
greget asliii sty masangin taktik gmn asnawi main main turnamen main kaku nabrak sanasini rafael nga taru dah didepan fungsinya sekalinya pergantian wals dimasukin pemain cicak	negative
biasalah bang namanya permainan bolamau gimana	negative
komentarin tolol noh	negative
sepatunya bagus	positive
nice	positive
emang pasion situ minimal bikin kontribusi lini bro komentator geleng geleng kepala	negative
grow koe luwih ra guno	positive
wasitnya qntol cek var bolehin	negative
goal rafael buang bkn tahan	negative
rafael ganti witannnn main egois mulu	negative
ngmpul gawang buang bola	negative
ngggkkk	negative
woyyy lini istighfar	negative
goal enak banget pemainan jelek kebanyakan gocet ujunga rebut goal irak kesalahan	negative
fultime cantumin cuman goalnya doang admin duhhh	negative
jordi	negative
lihat instagram cuy var jdi banget	positive
taru sok banget tinggal buang kelar priwit hati aman	negative
terulang semoga	positive
var bullsht	neutral
keep head boys im proud spirit nothing impossible better next match	negative
ganti pemain co banget	positive
alhamdulillah hasil	positive
akun fake la	negative
var	neutral
hahaha kesel kesel luapkan dikomen brow cetak goal canggung	negative
bangkityy babak garuda	neutral
kasih please pengen banget lihat bermain	neutral
sekelas messi kalo main indonesia mah cadangin kuch kebanggaan	positive
offside si	negative
bener bngt bang pemain sekelas lo cadangan	negative
entut banget pas nonton tv indonesia komentator indonesia berasa nonton liga hadeh	positive
bang	positive
jordi badut	negative
lini lini permasalan	neutral
tsaqoffi obsede ta obesitas mbah	neutral
goal pemain irak offside	negative
udah pusing banget liatnya	negative
bagong nggih coach bagong	positive
yok buly wasit	neutral
jujur era luis milla bagus sty mental pemain lokal asian games filosofi bola udah nemu daya juang stamina	positive
jordi tarik	negative
poin lihat permainan kyk kemaren	neutral
serius diganti tenaga	negative
bek loyoooooo anjj	positive
netizen doyan kritik bersorak indonesia matang permainan berkembang goal ngebuat ritme permainan berubah drastis offside berbuah goal keputusan wasit goal bener bener fatal ngebuat jalan permainan berubah garuda perjalanan mu mencapai kematangan berani memotong generasi muda kebaikan jangka mari lihat kedepan menyalahkan pelatih pemain dll bersorak mencapai hasil kematangan berani memotong generasi cepat membuahkan hasil bersorak mari lihat kebodohan asli netizen indonesia	negative
kezel	positive
mmy kaya offside cantik	positive
sumpala indonesia butuh atriker sananta	neutral
wasitnya kali goal offside indonesia	negative
beda si pemain naturalisasi pemain asli indogaada beda pemain naturasi minim kontribusi	neutral
struik ngapain cosplay dandi shoot langsung	neutral
mending disipilin nyekill lengket	negative
asnawi ganti dah wajib	negative
makassar	positive
rashford struick	positive
ijonk ampun kritik bahasanya donh	negative
main kalo gtu bang jago	positive
jordi pecat	negative
nih akun asli asnawi grasak grusuk gabisa kalem dikit	negative
offside kena kaki kalo kena kaki iyah offide	neutral
asnawi pengalaman banding wals kelas pelatih	neutral
terimakasih garuda berjuang	positive
dh offside	negative
wkwkwk wasit bikin geli	negative
marcelino biar keliatan bner² jago main individu	neutral
var	neutral
tolong investigasi goal ko goal indonesia	neutral
ndapatady pelan om ato v	neutral
lupa komentku hapus pengin ngakak dosa	negative
f makasih coach masukannya bermain mohon arahan coach	neutral
goal irak sah aduh	negative
semangat bagus banget	positive
coach masukin sandy walsh kanan mesti masukin si witanancurrrr masuk witan klok kambuaya permainannya salah passingancurrrrrr	negative
asnawi lawan pas argentina ngotot ilang bolanya halnya klok pegang bola lepas yagaksih sedihnya sandy mainnya cuman sebentar	negative
sandyyyy walshh mending naturalisasi manfaatin pemain bagus milih ngandelin lokal pret	negative
ernando jancuk	positive
pemain indonesia sat set maennya pegang bola	neutral
kali blunder berbahaya	negative
indonesia dicurangi haduh pemain irak offside offside gunanya var	negative
asyari ydh aja main	neutral
proud garuda fighting	neutral
makassar kelas assist	neutral
admin post komen ilangin	negative
goal goal obsed	negative
goal ngeselin tinggal buang dimainin	negative
bismillah admin babak comeback	neutral
menunggu info instagram wasit ny	negative
bang heran	negative
seneng dikit marselino ngegolin udah kebobolan lgicome indonesia	negative
sandy shayne	positive
asnawi konto	negative
var kocak	positive
emang	positive
blunder mulu si	negative
mainmu kyk taek rizki ridho	positive
tv	positive
pemain kacau	negative
ngakak	negative
marss pemain profesional bro	positive
sty sayang asnawi cokk pantekklah	positive
var asuuuuuuu	positive
anying	positive
goal injuri time detik woiii	negative
protes varrrrrrrm	negative
change grasak grusuk mulu	negative
dih ngatur	neutral
isokey yukk menang kalah pertandingan today may tomorrow	neutral
pemain underperform diandelin sty pelawak	neutral
tolong sandy walsh main	neutral
masukin sanantaa	neutral
lawan vietnam wajiib menang	neutral
marc klok versi cepak segarang versi gondrong	negative
dasar netizen	positive
offside cok offsideee ahhh	negative
cek var completed anj	neutral
check goal offside disahkan	negative
bangsat mode barca	neutral
dimana ramadhan sanantha	positive
goalll	negative
overrated pol pen lihat sananta starter dikasihnya mulu	negative
makassar banggga	negative
levelnya brune timor leste myanmar bro gaya maunya gocek mulu	negative
enak banget maenya semangat	positive
upsss	negative
jatuh kaget jatuh	positive
sayap kiri ngapain ganti arhan woo gunain	negative
serbu akun afc offside	neutral
ngapapa pengalaman boss mantap tim garuda	positive
rafael struick egy beter egy jaman aff	neutral
striker kalah body sananta ttap mines indonesia striker doang	neutral
outtt	negative
f jelekk gaush bnyk bacot belom tntu kayaa merekaaa	negative
besok pekerjaan	negative
offside gerakan pemain iraq	neutral
bang udah cek var dibatalin	neutral
gas goal garuda	neutral
bener struick kecapean banget keliatan diganti sty minim taktik	negative
semangat	positive
struick ngapain sii ajak ijik ora	negative
sebenernya rafael target man sayap nyerang	neutral
grow pelatihx cerdas melatih perporma sang pemain rafael sturick cuman lari lapangan jadikan startersudah saatx pelatih timnas sin tae young pecat ganti pelatih lainpelatih sin tae young warisan ketua sebelumx muhammad iriawan	neutral
struick ngapain anjingg	negative
walopun pesimis lolos respect	negative
wkwkw isoe teko kene ilo	positive
ivar jenner kelas	neutral
aff afc curangi wasit	neutral
offside	negative
semangat timnas	positive
iki ae jagoan pes aka	neutral
irak hoki banget elkan baggot nabrak bola barengan irak	negative
tuan rumah piala dunia menjamin qatar menyelengra piala asia bersih keputusan wasit var oh qatarwajah penyelenggara tercoreng	neutral
pemain yanh control bolanya asik ambil bola eh masukin pas injurytime udahlah terima kasih sty	neutral
vision	positive
ngarepin apadari timnas juara affini lagikwkwkwk	negative
var var wasit adil yatuhan	neutral
aturan offside sblm goal iraq gajelas jir	negative
makassar ewako	positive
rafael ganti sananta asnawi ganti sandy	neutral
elu ngapain si witan masuk bener yacob masukin pemain asrama polisi	negative
smt bng cek var lawak ajir wasit	neutral
indonesia iraq	positive
pertandingan pakai arhan asnawi menang	neutral
udah bener keturunan smua hadehh	positive
nge golin klw bawa bos lagih umpan yakob	neutral
minimal imbang maksimal menang ayo pemain panikan kl dpt bola lgsg buang asnawi jrg dimainin msh dpt kpercayaan mending ganti sandy kapt kasih jordi	neutral
semangat garuda	positive
bener pemain udah niat lari dibiarkan main	negative
mentang rajab ramadhan ramadhansn dimaenin	neutral
pelatih online ribet cari kambing hitam	negative
kadang oppah berharap keberuntungan menyertai opini pergantian pemanggilan edo diganti rahmat irianto butuh gelandang cok bek dah kebanyakan edo turun starting dendydimasegy dicoret saddil lilipaly super sub layak walsh kebanyakan camat berani duetin sananta rafael menit variasi bek formasi apapun hasilnya yudh tetep dukung kadang keputusannya bikin gregetan	neutral
gimana pemilihan starting line walsh sananta dibawa	neutral
setuju sty ganti dgn pelatih europa sty pertandingan bener bikin kesalahan kesalahan sayuri bagus babak babak mainkan wing back penyerangan babak optimal rafael struick babak kebigungan babak coba memasukan striker bayangan ganti struick pemain belakng iraq buyar konsentrasinya asnawi kalo ganti diganti sandy walsh defensive	positive
sandy main menit² haahhaa	negative
ayo timnas indonesia focus pertandingan garuda muda focus focus khusus jajaran pelatih pelajari kekurangan pertandingan jadikan pertandingan bahan evaluasi cambuk semangat pertandingan hebat titik semangat pemain muda	neutral
gppa semangat	positive
f norak keren	negative
rapopo mbak	neutral
bener bener butuh predator haus goal partner rafael	neutral
dibahas keputusan diambil pelatih shin taeyong objektif sty memilih asnawi dibandingkan sandy ivar diganti indonesia kreator membangun serangan yakob onfire winger ditaruh wing bek babak posisi indonesia tertinggal poin wajar poin diatas mengganggu sty memaksakan rafael struick striker tunggal posisi aslinya penyerang sayap indonesia sananta sananta berselisih struick sananta striker utama timnas coba dimatangkan objektif menilai faktanya pelatih pelatih paham situasi tim menerawang mengirangira	neutral
ngarep match nyetak goal uda ekspetasi bjir	negative
apasi ngehujat dukung timnas biar semangat udah skor ketinggalan gini ngehujat	negative
lokal prett	negative
fr elu nonton gemeter main mending diam blok	negative
segi permainan berharap juaratapi dukung timnassemangat king indonesia	positive
ayo one garudanext game	neutral
ah login asia dicurangi	negative
rafael asnawi arhan ampas banget maennya	negative
firaun setuju thailand lolos thn	neutral
rafael titipan si bngst	negative
goal ofside	negative
miss mending sananta dah babak	negative
struick km ayang	neutral
ganti pemain ngentoddd	neutral
cemil deg degan bgtt thsayyy	negative
hadeehhkok witan dimasukin	negative
maksudnya umpannya kena kaki pemain iraq kakinya didepan pemain indonesia maksud si otomatis umpan pemain iraq nyundul sejajar bebas offside	negative
yoojaehoon	positive
makassar kasihan sayuri team kayak tai	negative
bang fulltime bang update	positive
bener	positive
timnas kick detak jantung normal wehhh	neutral
please hate coment lanjutkan garuda	neutral
asnawi ganti sandy	negative
setia ganti bang sananta masuk line	neutral
yaatapi grerget mainnya bro ngontrol bola gj	neutral
wasit var buru diteliti sisi kanan sisi kiri	neutral
adminya berani posting hasil cuman pakai story cerita	negative
pantes panggil timnas	neutral
mainkan blunder	positive
insyaallah amin	positive
offside goal	negative
annisaa strukk ngapain	positive
cape	positive
napa bapaknya	negative
duh lino py kih	neutral
struck ngapain	negative
januari kalah	neutral
gunanyaa var apaa yaaa jelas² offside loww	neutral
bebas ndasmuuu	neutral
fr semngat bro semoga bawa indonesia juara piala dunia	positive
struick ganti banget	negative
fr hubner doyan blunder	positive
jujur mainnya jelek	negative
pemain profesional mbak mainnya lawan ssb	neutral
lucu rafael struick main	positive
info akun wasit bro silaturahmi	neutral
lini belakangnya amburadul	negative
wani	positive
ngegolin tuhh haha	negative
ayolaahh indonesia butuh kun fayakun mu allah	positive
nyeri hate aing monyetttttt	negative
heran bagusnya rafael stuk tai	positive
ayo dukung timnas hujat mulu go go timnas indonesia	negative
f bacot gedein bang	negative
seriusan offside	positive
lo najissss	positive
alah bacot doang gedein adek² struick coba main luh	negative
var	neutral
bilang ivar nyangka lino oper kanan sayuri maju nambah opsi build serangan eh goreng al hasil counter telat turun nonton nyangkanya oper eh goreng pdhal banget sisi kanan kosong parah keliatan goal indonesia kanan pergerakan sayuri kaya gtu kalo oper	negative
offside banget	negative
saddil kreatifitas	neutral
keren main blm rezeki aja semoga msh asa lolos hope	positive
rafael keluarin dah	negative
kalah	positive
gerak bgdia nyundul	neutral
bner catatan ane offside	negative
mark klok main blunder bae	negative
iraq dapet press bola lengket lepas dapet temennya press passing x bola ngilang	neutral
sayap kanan sma st gnti cuman ngopi doang	negative
sty ganti pelatih belanda indonesia cocok dilatih belanda brasil italia mengutamakan skill seni	neutral
cuman pemain cadangan selebrasi yaallah	negative
alahhh cerewet kali mulot bebek	negative
goodbye piala asia sesuai dg gembar gembornya ngapain bawa pulang pemain² keturunan dimainkanmalah mainkan pemain lawak	negative
pliss guys pendukung dewasa hujat pemain kalah	negative
peluang indonesia banget sayang menguntungkan unggul duluan irak pr pemain timnas indonesia berani shoot marselino peluang banget semangat timnas indonesia round yok timnas indonesia	positive
haha	positive
keknya enak nih silahturahmi akun cross check wasit varnya	positive
permainan bagus marshelino egois struick suka megang bolapertandingan ubah line mashelino candangin star syndrome bocah	positive
rafael jam terbang kalo jadiin striker piala asia sananta statistiknya bawa	neutral
bola sejajar badan si penerima bola cari rekamannya nih diamati	neutral
goal sundulan gawang	neutral
semangat garuda	positive
yakannn gerem kali	negative
semangat	positive
aowkwwk eta bek striker jibrug	positive
netizen kenp berjuang doain bully minimal kasi semangat	positive
asnawi dicadangkan diganti yacob lini duet padu ivar hubner ridho diganti sandy rafael	neutral
goal	negative
offside var system masak gibsa lihat	neutral
suka permainan sayuri andai support ny bkln bgus kiri pattynama mantep selebihnya magic pergantian pemain sty jelek apapun selamat berjuang memghargai perjuanganmu	positive
striker anak emas sty mainkan	neutral
udah ki duga marklok main kacau permainannya	negative
asnawi rafael	negative
wasit kasih tambahan menit	positive
brooo	negative
sempet cek var lho	neutral
bolaernando cosplay onana pemainnya kayak maguire awokwokwkwk	neutral
heran banget sma orang indonesia sukanya ngehujat timnas knapa knapa kayak kritik ngehujat pemain timnas masuk piala asia berlagak pinter ngejatuhin orang suport susahnya kalo menang mengharumkan nama negara tinggal kota piala asia bertrima kasih nyacat doang buka mata buka hati nurani capek mempermalulan sndiri dosa sndiri	negative
offside	negative
butuh coach coach	positive
rafael kalo ganti taru sayap gajelas ditengah mending sayap kalo engga ganti sananta	negative
dah bner cabutan pemain nama ego bintang cr messi tod	neutral
admin tolong tanyain sin tae yong witan dimas dimasukin fungsinya ngapain coba	neutral
timnas stamina kekuatan adu fisik	neutral
bener sty stay	positive
offside	negative
komentar postingan goal marselino dibatasi bos	neutral
kesel liatnya	negative
please ganti asnawi astaghfirullah	negative
jordi ganti woyyyyy	negative
goal irak offside cok complet	neutral
taru second striker bro	neutral
offside	negative
overall wingback timnas lumayan solidpertahanin arhan asnawi	positive
lini dirombak nihsering panikan	negative
pramudya vision kayanya berlangganan dlu mending gtu cari info live difb	neutral
bek kiri jebol	neutral
yakob menyerang tarik kebawa gantikan posisi asnawi sandy walsh pilih witan pergantian menit ketinggalan goal pelatih evaluasi iming membangun tim kak tai	neutral
sdm perbaikin kritik kalo gabisa kontribusi minimal bantu doa dilapangan berjuang	neutral
struik allah pengen bawa bola gawang	positive
bakhri beratt kalo lihat var	negative
next match pliss pasang sandy shayne posisi asli arhan cepat offensive bertahan telat	neutral
kesalahan terbesar sty laga memainkan mnunjuk capten tim memainkan	negative
pemain iraq nyundul didepan kaki nendang	neutral
bang	positive
komentator towell yukee pemain naturalisasi benci kali	negative
timnas indonesia mancen sip	neutral
woyyyylahhh ngapain main high press yaallah stamina pemain beda pemain korea bek body control composure bagus gapapa main mid blok manfaatin counter attack susah meredam kekurangan salah pemain salah sty	positive
check var mas mmang goal salah wasit	negative
offside si njir	negative
wasit var thailand qatar bau² berpihak iraq	neutral
indonesia klh	positive
witan main	neutral
klok	negative
setting anjj	neutral
goal offside duluan si	negative
hancurhancuran babak megang bola hilang pasing anak ssb aliansi suporter bola pemain siluman dendy witan	neutral
penonton	negative
diana towel ngritik gppa komen gaboleh bang	negative
offside	negative
adminnya lemes cuk	negative
var udah bayar offside	neutral
bahaya indonesia	negative
semangat jangn hujat dlu indonesia uda lumyan pda pertndingn masi bbk	positive
hubner buang nanggung	negative
var gblk	neutral
dibilang indonesia turu wae	negative
semangat garuda	positive
level kalah kelas bro	negative
kebanyakan gocek trs sty gaya bermain bilang possesion boro nguasain pertandingan bilang counter attack giliran dapet bola maju diem maju orang parkir bus cetak goal kalo menang aneh njir	negative
sabar guys pemain kt kali main piala asia muda berharap utk event syukur lolos piala asia pemain irak brp kali ikutan tunggu event	neutral
asnawi ridho ganti klok walsh hubner biar center back	neutral
grow yaudah lo main biar layak	negative
ngerasain dizolimin var kayak si ipul	negative
sandy masukin mnt lawak	neutral
jagain cokgregetan anj	negative
dont shame garuda ayo fightt	neutral
asnawi ganti ganti sandy walsh	negative
tombol degdegan jordi mai	neutral
nonton bola gausa bacot komen	negative
please deh kalo bola daerah pertahanan langsung arahkan kedepan terserah blunder mulu	positive
kipernya dh bagus banget bek bermasalah	positive
lihat timnas main afc terharu bngt	positive
suruh main badminton menang	positive
semoga babak gacor semngt garuda	positive
sedih timnas kalah afc gapapa lumayan sedihnya naek level hahaha karna aepep	negative
aaa kasian aaa	negative
ditonton resah ditonton gelisah	negative
kubilang turunin asnawi si pembuat onar turun yassa disupport mending outin bola dibanding oper yassa goal iraq bola dipindahin sisi cover bocor emang bangsat asnawi songong dikasi kapten	negative
ganti pelatih	neutral
marselinooooooooooo	positive
saran coach next match bilang pemain pegang bola unjuk skill kelas	neutral
rafael nih ganti	neutral
jordi deh mending	negative
tatap laga selanjut nykalah menang biasaindonesia masuk piala asia udah mantappegalaman piala² resmi fifa selanjut ny	positive
pemain kiri dpn dpn kurangin egoisnya kta ngejar point	negative
bikin goal gawang	negative
mainkan yong ah	negative
klemar klemer bang tenaga greget	positive
dendy masuk susunan pemain dimas drajad notabene striker murni sty kadang lawak pasang strategi rafael striker murni jadiin striker tunggal target man kebingungan dapet bola	neutral
faktanya didepan gawang si rafael bingung kaya naluri stiker	negative
ijonk muka kon	negative
fakta bang dpt peluang lepas kontrol jls oper komen dh tar hujat ekekek	neutral
witan masuk permainan rusak	negative
offside banget lbh dr sebadan	negative
makassar yo	positive
rafael mending suruh bikin seblak kerupuk deh	neutral
ofside	positive
kantong asnawi dah penuh isinya garnacho ngantongin pemain lawan	negative
putra rafael striker gadpt ruang beknya jaga wajar susah cetak goal bek indonesia gabisa jaga lawan mnurut rafael salah salah bek indonesia coba bek indonesia jagain lawan gaakan goal	negative
rapael	negative
kalo indonesia chant wasitnya goblk	negative
goal engga offside njir	negative
asnawi ganti ajalah bener bener gajelas maennya	negative
nice try garuda semangat match	neutral
fungsi var pajangan doangan	neutral
linoi offside sentuhan	negative
fokus bikin kesalahan	negative
yahh vidio premium	neutral
witan	positive
coba tantang main pemain irak coba	neutral
play sandy please bad starting eleven sub kidding	neutral
kapten cadangan	neutral
asnawi beban timnas piala asia	neutral
komentator bilang offside var hdeh	negative
offside harunya	negative
pemain sibuk berjuangnetizen sibuk ngebully	negative
setia sananta pdhal pas banget ngandelin skema counter tinggal spam long shot spam crossing	negative
struick cadangin weyy main klemar klemer bola taru eksekusi engga	neutral
babak pusyingklok	negative
main liga tarkam kocak bener dah pegang bola hilang	positive
wasit e ra ceto admin	neutral
dukung timnas	positive
ds semngat sory typo	negative
lost	negative
mls lihat asnawi	neutral
rizkiard sleding kabeh	neutral
info live streaming	neutral
upp	positive
sabar netizen	positive
penyerang paket beneran	negative
naha sin tae young lila pisan pergantian teh	neutral
info instagram wasit	neutral
sananta daftar main	neutral
inpo instagram wasiit	positive
arhan tag deh ignya	neutral
akun fake	negative
rafaell kbnyakan gaya	neutral
sty udabukan taktik lebi pilosifiitu friendly match sty kontoll	positive
semangat timnas indonesiasemoga pertandingan timnas panen golselalu menang amin	positive
sty melawak asnawi ganti witan sandy apain bangku cadangan salah pemain kalah	neutral
target sesungguhnya piala asia	neutral
timnas butuh stiker haus golll	neutral
semangaaaaat menanggggggg	positive
wadaii hhh	negative
langsung kumpul guys	positive
kontrol bolanya ampun dah	negative
pemain tarkam kegocek	negative
bismillah nyusull skorr babak smogaaa indonesia unggul poin	positive
asnawii sandy	negative
kebanyakan komen goblok	negative
elkan bagot bapuk parah	negative
kambekk full match	negative
taru admin mainnya ayooo fokus dlu	neutral
comeback laa saudarakuu	positive
keren sayuri pemain liga indonesia	positive
offside cuy	negative
sipaling	positive
sananta bodi ok tendangan keras letoy banget tai banget dahh	positive
rizkiard kualitas pemain naturalisasiaka	neutral
cari instagram wasit guys	negative
ayo semangat bales iraq kuat kesalahan ayo ferdinan sayuri	positive
captain problem	negative
asnawi change	positive
ginii mo lawan jepang inii mo req brpa goal jepang	neutral
var jnck	neutral
murni kesalahan goal irak	negative
bad perform	neutral
good game garuda	positive
sty masang bek	negative
terimakasih bangga	positive
hakim garis butuh obat mata minus	neutral
admin tolong lock kolom komentar habis komentar negatif	neutral
bacotemang kyk lino	negative
bang bang bawa bola	neutral
timnas keren bodo fans karbitan dukung kalo menang hujat kalo kalah bikin negara sono kalo menang main bola gampang ps hidup indonesia	negative
offside bang wk	negative
klok kambuaya payah bener	negative
wahh rada²	negative
yd terima babak hrs goal indonesia	neutral
sia sia nonton timnas irak ngebantai timnas indog	negative
jantung masi aman	neutral
starter asnawi hilang bola	neutral
setia ganti sp dimas dendy	neutral
asnawi arhan kesayangan sty	neutral
wasit deh good job timnas garuda keren mainnya esokk semangatttt	positive
official vanya orang thailand	negative
goal iraq offside sii	neutral
asnawi ganti allah ngeri liatnya	negative
bizar liga lokalnya buruk kualitas liganya sejarah sdh membuktikan juara tim tampil salah faktor terbesar liga lokalnya	negative
ah nggak keren	negative
gajelass lol	negative
tap doang main jelek	negative
gimana pa offside tida pakalo tolong tindak	neutral
apapun hasilnya terbaik	positive
keserang	negative
fr sty pelatih berbahaya pelatih perusak karir pemain arbrod negeri	negative
pulangin az shandy belgiapelatihnya butuh jasanya dsnadi timnas camat kasihanpemain liga belgia kalah pemain liga korea	neutral
intinya indonesia juru kunci	neutral
beck sayap dipertandingan shyne pattinama sandy wals starter ivar jenner opsi babak dimasukinnya buang makan timnas menyerang klok mending mainkan starter opsi penyerang hokky dimasukan saran asnawi wintan mending dimainin	neutral
dah capee pemain bagus cadangin kaya sandy wals	positive
sandy main setenang kluarinnya mnit hadehhhhhhh asnawi mulu curiga asnawi pnyaa kartu sty	negative
makassar ewakoo assist	positive
offside	negative
timnas butuh pemain mutiara hitam yacob sayuri	neutral
oppsideee cokkkk	positive
makassar yacob fire	positive
ultras indonesia woyy	positive
formasi bek jordi elkann ridho klop blunder fatal merugikan timini dirubah coach shin coba allternative bek	neutral
sangar awakmu cak	positive
egois	negative
justin perform	positive
ayo garuda main agresif	neutral
striker bapuk gini	negative
habis stamina kejar lawan taktik permainan kacau gunanya orang pemain naturalisasi kalo cadangkan aneh	negative
kompak	negative
offside ituu goal wasit tolol	negative
rafael kurangin nafsunya	negative
admin bacot banget dah perasaan	negative
asnawiin sandy struick ganti pemain kebanyak ribut bola pegang bola grasak grusuk	neutral
asnawi ganti	negative
jamet	negative
coach shin lupa mainkan rafael wkwkwk lari pertengahan babak kontrol match bagusnya wkwkwk	neutral
pemain ngapaean	negative
shane patinama cetak goal lawan irak dimainkan cuk	neutral
gemes banget mainnya lihat rafael struick	positive
ernando kesulitan build bola buang hilang	negative
semangat bsa ngegolin alhamdulilah	positive
babak gaada visi nyerang sisi kanan pemain kiri kosong egois banget bawa bola next match kurangin bawa bola imbang permainan	negative
walsh bertahan emang keren cukmasuk menit duel aymen menang udara taru unggul udara pendekjam terbang eropa mmg bohongmana main tenangsemoga vs vietnam walsh masuksayuri sayap kanan bagus diamark klokdan kambuaya main td grasakgrusuk pertandingan td pemain permainan konsistenivarmarselinosayuri baggot ridhoini	positive
terserah	negative
taru sumpah kalo match sandy shayne stating line sayap dah bagus marselino yakob asnawi ganti masuknya sandy witan	positive
id kalah body	negative
linoi kalo diliat ulang offside var kaya	neutral
yakob enak tinggal dikasih terobosan manis sandy wals asnawi handle pemain irak lawan kelewat salut arhan dihujat tetep fokus balikin performa ribet ngurusin netizen kayak kapten pantes anjingggg pokoknya	positive
asnawi ganti masuk sandy wals dimas drajad	neutral
proteslah afc diem bae	negative
sandy masukin	positive
aneh bet bisa²nya coret	negative
lo main ribet	negative
tolong ganti asnawi parah	negative
masuk dimasklokkambuaya hancur	negative
kartap fix	neutral
rizki ridho kalah duel	neutral
fix witan pemain titipan	neutral
akui murni goal sundul kena pemain iraq offside	neutral
butut amatt taiiiiiliat nohhhh terpontang pantingyg sekalinya dapet bola ilang santai banget asuu asuuupassing orang passingudah taru press maksa passingtenangan dikit lahhhliat cape nahan dapet bola bentaran ilang lagii	negative
si rafael kenpaa ajigggggggggggg	negative
vizcarra yacob underrated player	neutral
waset anjenggg offside cok	neutral
apapun hasilnya suporrtkalian berjuang inilihat bermain piala asia senengsetelah sekian absen	positive
posisi mereng ngeksekusi disebelah oper dikit oranggg	negative
egois	negative
rafael stroke ganti	neutral
info instagram wasit hakim var wasit kelas rendah gaguna wasit hakim garis afk	neutral
kinerja totalitasnya lapangan cerah garuda	neutral
berharap apapun pemain timnas club masing² selamat bahagia	neutral
mudah²an iraq menang allah biar cuan ane minimal iraq indonesia bismillah	positive
info instagram wasit ruang var admin	neutral
pelatihnya sat set baca permainan sty sty	neutral
ayo minimal seri iyah kalah	neutral
jenner hubner ngapain si mending mainkan pemain lokal	negative
asnawi ganti sandy walsh	negative
rafael ganti cokkkkk ilang bola mulu	negative
cobalah main	positive
rafael struc main simic	neutral
coach maaf kalo akun provokator wkwkwkwk minimal kl kritik bener	negative
layy salah bro bkn buang k	negative
santai laga vietnam indonesia jepang indonesia	positive
bawa sdm bawa sdm awkwkwk blok ngomong dikit dikatain sdm rendah bused ngeri	negative
sipalinggg maennya jago ajaa luuu bangg	positive
komposisi starting line babak bagus permainan cair umpan sayap kiri kanan ok mobile banget hidup pas babak parah pergantian pemain sayap hidup umpan matang karna tengahnya berfungsi klock kambuaya bingung umpan kesiapa bikin serangan klock parah banget menguasai mobile bola direbut lawan karna telat ngopernya ngoper bola bagus tanggung overall starting line babak pertamadaripada semenjak digantikan intinya evaluasi pemain diindonesia pemain bagus ambil pemain becus ngoper bola mending belajar ngoper bola	positive
sandy asnw	positive
sebenernya goal irak offside	negative
ofsidee ituu tadii	negative
gwenchana gwenchana menit	positive
wasit ny	negative
bingung	negative
seperkian detik fokus	neutral
berharap indonesia menang udah bener aff	positive
var good ofsite	positive
inst ejaanmu lo salah	negative
seengga mempermalukan bangsa berkomentar etika pendidikan minimal serendah	negative
lihat ambil bola wajar umurnya muda mateng lawan brunei bro keep strong	negative
bubarkan timnas indonesia match uji coba udah kali main gtu dibiayai negara kalah pelatih bayaran mahal hadeh	negative
wasit kesentuh ajukan protes	negative
klok blunder struick egois	negative
tidur besok sekolah temen temen	negative
wasitnya diserang parah offside cuk	negative
bagus bagus	positive
offside anjerrrrrrrrrr wasit tolol	negative
kebanyakan buangpeluang mulu	negative
asyari salah mulu rafael	negative
yel yel garuda indonesia	neutral
bermain terbuka menyerang ayolahhhh	negative
maksimalkan babak sob ayo	positive
next lawan vietnam bek biar goal	neutral
coash online silahkan berkomentar	neutral
mack klok ripuh	negative
offsidee goal irak	neutral
cek var banget ajg offside gtu	neutral
semangat garuda	positive
bener main sentuhan ehh long ball long ball huuffttt	positive
apk edit poto biar bergaris pakai apk ngab	neutral
cek profilll	neutral
heran tambahan menit peluit tiup menit	neutral
yakob topp mainnya kayaknya lawan jepang auto bantai kalo gini mainnya	neutral
lord blunder terusssss	negative
bek sayap banget next pattynama sandy starter	positive
terjajah korea	negative
usia muda muda harapan timnas dimasa	neutral
f diajak jalan eropa mknya pinter main bola pinter ngetik ngehujat timnas sdr	positive
ayooo rapat mainnya nih menang ayo	positive
riski ridho posisinya ganti hubnergacocok ridho elkan	neutral
bek mu keselll ganti	negative
tapikan rafael ganteng	positive
sturick ganti egois bet	negative
rafael asnawi	neutral
ijonk manusia sok jago muka bumi	negative
babak bismillah comeback gasss blunder	negative
lumayan bujanginam kacau	negative
asnawi ndagel	negative
nntn bola smpe dl coach online bru komentar pertandingan blm mnt pas komen udah main marah waeee masbrooo	negative
struick aduuuh yok bisaaaaa	positive
suport bang buli kasian muda	negative
main panikan	positive
pemain indonesia kalo udah lini pertahanan sndiri langsung hilang fokus alhasil kebobolan deh	negative
komentator terdengar menyepelekan pemain naturalisasi yagasih	negative
dimas drajad striker murni naluri pemburu goal banding rafael struijk notabene second striker si rafael muda visi striker tunggal	neutral
timnasbisa mrnang	neutral
haikal bang bnyk naturalisasi pemain bertahan eh pemain posisi bikin timnas hancur	negative
naturalisasi udah pelatih bagus udah tc jga nunggu	positive
bagus mainnya semangat garudaku	positive
arhan lambat lepas mulu lawan ganti	negative
asnawi modal ngotot intelektual nol	negative
witan masuk kocar kacir sebelah kanan	neutral
kebumen offside ngumpan posisinya dibelakang bek kayak menerima umpan	negative
mending fachrudin aryanto deh deffendernya asli beliau dipake sosok kapten	neutral
rafael ganti mainnya egois	negative
ngegolin wkwkwkwk	negative
offside goal	negative
bang bangga ngeri si uda berusahakita uda ber kembang	positive
stop hujat timnas saudara semangat garuda	neutral
ngapain klok dipasang hadeh	negative
pertahanan masi grasak grusuk	negative
info scor nonton masi diperjalana	neutral
jordi jordi	negative
komen trs	positive
kecewa hasil bang komentar ngerendahin bang motivasi pemain bang next game	negative
wasit wasit dalem negri lawakkk	negative
ampunn arhann kacauu	negative
sabarr	positive
berat lawan irak bedah permainan iran kuatkuat pemainnya timnas indonesia kalah body	neutral
aaa kasiaannnn aaa	positive
prediksi point indonesia jepang point iraq point vietnam point indonesia point	neutral
belajar passing moment krusial salah passing tai	neutral
pengacau	negative
tabrak	positive
sayuri gacor	positive
komentatornya ganti asli	neutral
jordi yanto basna	neutral
lihat	positive
mainkan sandy walsh woyy pelatih posisi tertinggal mainkan witan kont	neutral
kecewa berat cok	negative
minnn selebrasi lino	neutral
goal ofsaid si nyudul pemain	negative
fuckkkk	positive
offside cok	negative
setia sip si main bola ngerti main bola alah bang sok banget orng	negative
main egois njirr nendang letoy bangett	negative
seneng sebentar doang	negative
panggil sty jgan	neutral
offside ituuuu woiii	negative
iqbal kritik membangun hate contoh asnawi nyaranin fokus ningkatin performa balesin netizen komen bales suhu kuh goblok pemainnya pelatih disitu sandy wals dibawa kemanapun tetep wals diatas asnawi kenyataannya anak emas anak emas anak emasnya goblok	negative
kalo megang bola kebanyakn gocek	negative
gurl akun fake gajelaaaasssss jelas² mainnya egois dibela dihhh najissss	negative
gas seerbu instagram	neutral
bek dobol	neutral
arhan beban tim mending edo jam main bola kebanyakan liburan jepang	neutral
rafael ganti dimas drajat ajaaaaaa	neutral
timnas vs timnas senior iraq harap maklum timnas pemain muda bangga timnas cerah	positive
kalo lihat tayangan ulang offside	neutral
sekelas ketum bilang kalo piala asia senior pemain untung belajar berlaga gelaran piala asia pecinta sepakbola support support menang kalah rame ngehujat	positive
e rela timnas kasih fasilitas mewah pakai pajak bayar pemilahan pemainnya bapuk rafeal	neutral
grow si layak	negative
offside	negative
goal bolanya kena rambut nyundul offside	negative
e setuju	positive
komplain offside	negative
rafael rapel	neutral
gregetttttt allah bisaaaaa	positive
matalu asnawi jordi noh	negative
yp lemes bang	negative
bek hancur	negative
finishing bodi	neutral
goal goal vini jr final champions vs liverpool anyink	neutral
sekelas sandy walsh masuk menit lawak emang sty ganti pelatih eropa	neutral
selamat	positive
main mending drpd kritik tai	negative
putra hambub mainkan bang kanjago mahbub	neutral
pemain butuh support kecewa sebatasnya lawak banget lihat komenan netizen sok taru banget bola keep stronger timnas	negative
tinggal pemain nih ok defense kemajuan signifikan okay tinggal matengin	neutral
nzl kayak kebingungan engk bang	negative
sampek batesin komentar	negative
haha	positive
setia pikiran sty striker asli sananta ngapa starter pdhal bagus badan cocok duel finishing jga mantep	positive
main kaya lawan jepang udah tandain nih admin coment dijadiin content	negative
offside si	negative
leg percaya	neutral
nitip	negative
keep enthusiasm national team	neutral
klok witan jordi asisten wasit goblok	neutral
amplop tebel	negative
timnas irak sebenernya bagus mainnyamenang duel udara jago guling jago mancing emosi	positive
indonesia lolos	neutral
wasit mata kayu	negative
omong takutnya ulti hattrick lino	negative
elu pengangguran	negative
lo bacod	negative
kalah jadikan pengalaman latihan keras ayo garuda	neutral
bilang bener grasak grusuk kaya gavi	negative
f nggak suka nontonkasian munafik namanya kalo nggak suka nonton	negative
goal iraq abnormal ofset ayo netizen ofset biar complain	negative
shayne sandy sananta	neutral
bisa² tidur	negative
spil instagram wasit ny	negative
gaada sentuhan bang pemain sah onside	neutral
efektif coba bek sayap mainkan arhan asnawi percaya starter shayne sandy sandy kualitas dikasih main dikit banget sty miskin taktik mainkan ganti pemain	neutral
serang akun asiacup	neutral
f bacot jijik liatnya	negative
plis lahhh goal pemain bengong seperkian detik banget lihat momen gini dilaga timnas detik ngaruh plis lahh tolong penasaran hokky rafael istirahat kuatin badan evaluasi gimana biar ilang gorengnya marsel pliss laa kambuaya cocok kalo lawan musuh mainnya agresif tempo marc klok sorry kali effort banget bawa rumah	negative
sty si starter goal gampang banget dilewati heran sandy bagus sandy masuk super sub menit visinya defensenya oke mudah dilewati sty dievaluasi sandy pilih asnawi si klok kayak anak passing kontrol bolanya bener tingkat tarkam kambuaya haduhhhh	positive
nggak ngedukung pas kalah nggak ngerayain pas menang keep enthusiasm future evaluations	positive
silahkan silahturahmi terputus	neutral
asnawi ganti sandy	negative
ofside	positive
nyari pemain naturalisasi ko nanggung keturunan indonesia klau nyari pemain naturalisasi berkelas kanca sepak bola dunia pemain naturalisasi lokal mah populasi warga indonesia ajaa goblok sty pemain timnas kaya gapunya strategi banget jaman luis mia isu isu naturalisasi pemain timnas pegang luia mia masi enak permainan nyaa	positive
var ngecek posisi proses goal utk kejadian kali official coach bantu sty wasit cadangan pemain ragu angkat tangan emang masuk posisi offside fokus babak utk bikin imbang hasil akhirnyam semoga semesta mendukung utk	neutral
rafael dah	negative
asnawi gampang lewatin	negative
bener bang percayalah cetak goal pemain timnas muda stamina kuat irak tuatua stamina kedodoran	positive
terimakasih berjuang skuad garuda next semoga meraih kemenangan	positive
setiana gantiin ente main	neutral
greget rafael suka gocek² umpan teman	positive
coba fans rafael struick puja puji menurun performa	neutral
pratama sumpah kalo si sananta kuat main menit si struick jadii camat timnas	neutral
sabar bang	positive
selasa suram mah	negative
jumping headerada touch ujung kaki pemain iranjelas offside	neutral
pecat sty	negative
komen tertolol	negative
syahrizon berusaha update story followers langganan baang mah nilai struick segi lini baggot dll bagus sayuri gendong² parah udah beuhhh sang maestro ivar jenerr duet hubnrt cuman stiker struick jauhhhhhhhhh banget mateng jadiin striker level asiaaa serius deh	positive
kiri lumayan bang kali arhan matahin peluang pemain irak kali arhan ngeblok bola crossing pemain irak keliatan rapuh posisi asnawi asnawi kali kehilangan bola passing nyampe blok lawan kali asnawi kepleset asnawi permainan ngotot	negative
posisi kayak asnawi mudah terlewati	neutral
da harapan	positive
bayar rb td	neutral
believe	positive
percaya proyeksi piala asia umur smua skuad smga tmnas bsa mnglahkan vietnam timnas menang tipi sandypattynamasananta main	neutral
ntah pertahanan oleng semuaa	negative
iqbal pingin ladenin ae hate comen mrekaamasa gamau lihat dlu smpe habis ngehujatdikira gampang	negative
taktiknya bagus tinggal passing	positive
sundulan kagak kena cuy offside	negative
info instagram wasit	neutral
babak lumayan ok babak blunder sty witan masukin marsellino ganti	neutral
rafael ganti	neutral
elu suruh main ngos ngosngosan ngab	negative
bawa bench	neutral
riset game play dah progres minus suka bikin kesalahan fatal	negative
congrat matamu cokk	negative
main bang eluemg segampang	positive
asnawi dfend	positive
udah	negative
rafael	positive
timnas selebgram fc	neutral
reno heleh berlindung kritik pahami dl gmn kritik disertai saran coach online	neutral
main gampang pemain bola gblok	neutral
rafael	positive
sananta hokky warming jordi biar diisi hubner klok masuk	neutral
lahh afc kayak aff cek var var cuek wkwkwk offside biarin aja	negative
kunciin nomer	neutral
nalar	negative
marsel ngescore awokwok	negative
komen tolol score mrubah jalan prtandingan tlol banget	negative
masuknya witan merubah ditambah klok kambuaya buyar	neutral
bangga permainan indonesia wlaupun kalah apresiasi kpda pemain coach sty indonesia skrang dlu berbeda dlu mengandalkan kebanyakan long ball skrng kaki kaki keren si minusnya staminan stamina dah bagus indonesia masuk piala dunia	positive
capeeeek kali nonton ajg	positive
sdh senang sdh imbang eh tmbah degkan	positive
kualitas liga keliatan bangett	positive
suwandy ayok silaturahmi kesini manteman	neutral
semngat timnas apapun hasinya	negative
habis pikir sty sandy klub starter timnas indonesia cadangan hadeeeeeeh	negative
adinda coba jelasin pergerakan gimana pola main timnas babak keseringan delay hilang bola lihat rafael dapetin bola muter visi buang momen begaya sok ngerti sepak bola ngerti	negative
bikin kecewa wasit indonesia main aneh	negative
kalo kalah pulang malu maluin tim naturalisasi gimana ko dieumingett lokas bnyak masuk timnas	negative
ardty ngerii lak	negative
wingback ganti smua	neutral
mental indomie	neutral
meng anak emaskan asnawi mainya buruk bek eropa ko cadangan	negative
gatauu var kagaa cokk	neutral
menunggu komentar	positive
wasit parah cokz var wasit dr thailand cek var	neutral
lmnfds bro offside gmna	neutral
bro mending rafael emamg ujung tombak positioningnya bagus dibanding dimas	positive
cok modal ganteng doang idol idolain heran netizen indonesia	positive
fathony udah seneng bat ofside bangkeee	positive
perangkat pertandingan indonesia vs irak wu ilgiz tantashev aw andrey tsapenko aw timur gaynullin wvar salman ahmad falahi awvar sivakorn puudom th sadullo gulmurodi	neutral
okay gapapa semangat indonesia	negative
sty menang lawan german pas germany bapuk	neutral
sty ambil keputusan pemain sdah diganti digantii ambil keputusan ganti pemain salah ok next game semangat	neutral
makassar kalah produk	negative
lini ivar marcklok marselino	neutral
harapancome garuda	positive
hrsnya ridho elkan justin	neutral
janah menang	positive
wasit pekok	negative
kebanyakan pemain naturalisasi main gkbagus dribbling bola ntah kayak mna beli mantan couch timnas north korea piala dunia	negative
wkkw	positive
beban	negative
masuknya marc klok bikin amburadul	negative
raja menyimpan video porno mengeluarkan statement	neutral
seandainya pemain ancuran udah ngimbangin iraq emg dasar kualitas pemain parah	negative
offide engga cek monitor kamera offside	neutral
ayo garuda ayo main berani lagii	positive
kekalahan kekalahan kegagalan kegagalan sesederhana focus vietnam january garuda dadaku forza indonesia	neutral
isann cek teros bwang	neutral
asli ngerti masukkan pemain titipan smj naturalisasi mainkan sungguh sandy wals bagus bangku cadangan heran	positive
posisi asnawi gampang tembus plis kse kesempatan sandy	neutral
wkkw lngsng matiin tv trs tdr tkt nyakitin tontonin trs	negative
loba teing mikir ah maena	negative
arhan bloking crossing	neutral
offside	negative
komentator bilang offside aneh allah var	negative
asnawiarhan sandy	neutral
bener ka sedih baca komenan berjuang	negative
ardiansyah kongkong urunan ae sak indonesia ewu gawe ngerecrut bang dodo ae piye om agendakan	neutral
ferdinand gda gregetan	neutral
gc tul gx pakai striker murni sananta dimas drajad maenkan umpan silang dr arhan gx nyambut trs td	neutral
offside iraq posisi banget	positive
tinggal nunggu farewell mah sty	neutral
beranggapan offiside mas mas bilang tiduran doang nyentuh bola offside noh lihat goal dianggap	negative
ngk ngapain	negative
rugi tuku var	positive
wkkwkwkwkwwkwkwkwkwkwkwkkw	positive
stater main bagus main kdua berjuang skuad tenaga membela garuda dada	positive
outasnawi sandy wals	neutral
offside	negative
wita tai	neutral
kalah pergantian mnt	neutral
vhee var dog	neutral
asnawi loba teuing gotak getok ey	neutral
wes karepmu menang	positive
bales pakai makian bro nemu	negative
msinulingga yoojaehoon tolong ajuin protes fifa afc proses goal iraq sempet offside sundul pemain iraq	neutral
nama instagram wasit silaturahmi	neutral
bilang mending mainkan sandy asnawi asnawi cocok winger kalo bek grasak grusuk goal gegara doang anying ngapain coba lompat segampang tipu hadehhh hadehh	negative
reno nntn bola smpe coach online komen blm menit pertandingan eh udah protes waeee masbroo	negative
var emang dipake lol	positive
keep spirit rafa team dont listen whats said social media	neutral
rapael stuikkkkk kntlllllll niat maenn bgsatttt	positive
struick ganti sananta berani anjirr	neutral
ok timnas garuda semangat tanks berjuang keras bias	positive
strikernya astagfirullah	negative
sady wals main	negative
wqwq gatau dah gwahh	neutral
tolong asnawi diganti sandy lihat permainan timnas lari larian kesana kemari lini bapuk yakop winger marselino striker rafael jarak shoot tendangannya terarah marsel okay kali sananta	neutral
mending upload admin isinya hujatan	negative
babak live	negative
aaaaa kasian aaaa	negative
cok wasitnya offside	negative
linkstream	positive
ofsidee goal iraq	neutral
najis bacot	negative
gunanya var	positive
score applause sayuri terbaik match	positive
si ntahlah	negative
toooo looooo lllll	positive
sty outtt	negative
japan menurunkan tim utamanya timnas indonesia menutup ruang tembak bola liar kanan kiri japan laga memiliki kesempatan poin struick dipasang sbg striker larinya berat sananta diganti dimas babak	neutral
asli	neutral
bener bngtt dahhh	positive
cok goal iran ofside mari cari instagram wasitnya serang haha	negative
ngerti bola lon	neutral
bawa bola pasif gerakannya	neutral
mental kena mental duhhh	negative
full squad aja keturunan admin	neutral
hate please semangatt guysslanjutkan	positive
f si bayar pajak cokk	neutral
bener bang kasian atlet keganggu fokus gara hujatan	negative
wasit	negative
ayooo semangattt babak menang balasnyaaa optimiss	positive
sii ofside offside duluam pluid tiup gmna	neutral
sabar babak nih	positive
pegang bola panikan	neutral
grasak grusuk toook	positive
bangkit	negative
timnas berjuang lapangan ehh nitizen bangsa indonesia berjuang mencari kesalahan pemain	neutral
linoi maksudnya kesundul kaki pemain timnas kalo jdi offside ntah	negative
tolong coach bagus sty cuman fisik sma lokal player main simple gocak gocek afc aff	negative
indonesia smj timnas pemain titipan memenangi apapun kompetisi	neutral
bingung ambil keputusan	negative
babak yukk	negative
jy bang ingetin jordy ilang blunder	negative
wailah lupa bang kualif asisst kl kritik membangun mah ngehujat namanya fans timnas ko hmm karbitan ye	negative
bang	positive
emg sty langsung ganti struick pergantian slaah masukin witanancur babak	negative
bilangin bola langsung umpan dikurung rebut bola jngn kejar hadang	neutral
offside coo	negative
angkat koper	neutral
head boyson next	negative
offsideasnawi kalo tarik tw	negative
rapael lari lari gajelas	negative
pahl tiimns indonesia bagus mainya perubahan coba lihat tetangga kalah hujatan	positive
egois parah bocah pembawa sial lini	negative
bjirr	negative
marss salah emang mainnya pokus	negative
aaaaaaa kalahhhh aaaaaaaaa	negative
cari kesalahan pemain var lihat tah wasitnya picek dah ofside dirugikan tolol	negative
witan payah ngapain panggil	negative
even australian commentators said clear offside	neutral
jujur lihat sakit hati gmna secinta timnas indonesia	negative
ati ati bang diserang cegil rafael ngandelin muka	negative
trimakasih garudaku berjuang semoga pertandingan go go go	positive
semangat latihannya squad garuda	positive
rafael ezra walian letoy mending ezra cetak goal wkw	neutral
rafael bocil dimainin banget	positive
maksudnya jordi tenang	neutral
keren berjuang bangsa negara	positive
sayuri permainan malam kelaszz	neutral
bagus apanya main egois letoy banget nendang bola	negative
priwit tinggal nunggu detik	neutral
umpan cantik umpan tergolong mudah dr sayuri	positive
offside anjirr	neutral
main bagus cuman menit gantiin dlu asnawi performa terbaik yasuri diganti coach	positive
arhan bgs bgtt ngeblok tendangan lawan semangat han	positive
sporter kardus	neutral
mending var kasih liga ksh var ngerti makenya pas pildun var bagus ko beda pas afc	positive
haha tlol main lemes orang teler blunder babak lawak	negative
sandy wals asnawi	positive
setia bingung ge struick cocok gelandang serang duet marselino pergerakan emang bagus posisi striker big	positive
mainnya egois	negative
percaya indonesia inii	positive
gempur malam dg kualitas main vietnam	positive
kaya ngerti bola	positive
pliss kalo bola udeh dibelakang langsung buang	negative
ngapain anjgg	positive
bocah emg berguna mending ganti si	negative
suka gaya	positive
tinggal buang bolanya grusak grusuk kotak pinalti	negative
ayo man expect dg striker udahlah kasih semangat agresif dg pressingnya jarang bikin high turn	positive
lha goal jls offside	negative
ball position	positive
kabiasaan nga ganti pemain ker garacor	negative
pemanasan	positive
sayuri vs everybody	negative
semangat indonesia kalah var permainanmin bilang sty suruh stikerrr stikernya haus goal	negative
pertandingan lihat optimis piala asia bicara tunggu qatar part pas	neutral
bismillah babak	positive
awowkwkwkkwkwkwkwkwkwkwkwkwkwkwkwkwkwkwkwkwkwkwkwwkwkwkwkwkwkwkwkwkwkwkwkwkwkwkwkwkwkwkwkwkwkwkwkwkwkwkwkwkwkwkwkwk kecewa struick	negative
pdhl tinggal buang td biar kebobolan tolol emng	negative
asnawi keren	positive
nomer gantinen koyo untul bawang	neutral
btw struick main menahan jempol menghujat percaya gakan ehh piala asiaaa ajaaa perubahan	negative
temen pecinta timnas mohon lihat timnas gmn kta berharap udah hasil bagus pemain kta krna emg pemain kta termuda mines jam terbang disamain sm irak pemainnya udah matang plis klian emg timnas berkembang aktif disosial media nyerang instagram pemain norak	positive
asnawi heran sty	negative
tidur bang	positive
posisi keputusan var	neutral
dah var	neutral
golin	positive
rafael kocakkk	positive
prediksi skor win indonesia amin allah	positive
onside anjg	positive
terimakasih timnas indonesia berjuang bek tolong ganti	neutral
kalok goal turnamen setingan anj	neutral
bang ngasih semangat ngehujat main bola bsa ngehujat serba	positive
goal offside	negative
woyyyyy ganti woyyy beban astagaaaa	negative
bp nahh ituu kalo offside lumayan	neutral
imbang lawan jepang bermimpi amin	neutral
kembalikan lord dedik drogba	neutral
dark system var	neutral
luweh njenengan mas	neutral
h beda rafael mah	neutral
mari kasih semangat stop hate coment	positive
ajukan protes goal offside	negative
asmawi ganti babak grasak rusuk maennya	neutral
lawan iraq gini gimana lawan jepan	negative
yakob	positive
sturik ganti main gocek gocek sok jago	negative
offside pergerakan pas kena ernando bola	neutral
yokk bisaaa balikin press semangat yoo garuda	positive
klok ampun	negative
waras	positive
asnawi ngacok	negative
lord dedek berulah sadil coret bingung	negative
nama konoha bang	neutral
oh komentator keren pelatih online	positive
lho lho lho hapus komenan pakai instagram pakai akun kelompok kocak neng	negative
sintaeyong goblok	negative
goal udah nangis pdhal terharuuu semangattt guysss balasss	positive
asnawi sandy	negative
nadeo	positive
rafael buruk banget maninya	negative
kerenn habis mainnya timnas arhan ganti pattynama wals struick ganti sananta mantep	neutral
rafael sananta	positive
rafael panikan anjerrr	neutral
sekian bnyk pemain indonesia terpilih pemain ajaapa karna jam terbang pemain udah bnyk jdi udah butuh pemain indonesia	negative
ayo garuda	positive
okay berjuang mudah comeback tertidur tampil asia sulit permulaan puncak semangat fokus next match	neutral
kalah irak	negative
ahahahahahahahahhaahahhahahhahahahahahahhaah	positive
indonesia cocok napa maksa efektif coach shin	positive
babak kembalikan semangattt	negative
wasit wasit liga haha	negative
ijonk bahasanya yaampun	negative
elkan baggot pemain irak gangguan pa msh muda blum mateng	negative
kaptennya pasing	positive
mental cemen blok	negative
gapapa kalah piala asia kali bkn rezeki percayalah piala asia pemain berusia memasuki usia emas gantian mendominasi piala asia	positive
sananta mainkan	positive
main bola gimana	negative
receh lo lihat pas sblm goal sdh posisi offside wasitnya gazekalau wasit niup peruit mh goal k	negative
ganti struick oppa mending sananta visi bermainnya	positive
sandy dibutuhin sm klub drpda sm kuch kesayangan	neutral
var merda	neutral
akun privat maido kyok kon isok isok ae tel gatell	neutral
hahahahaha	negative
hahahahaha	negative
linoi	positive
peningkatan anj pelatih minim taktik pemain tenang presing langsung panik pasing pasing pemain bintang gocak gocek naturalisasi loyo bedanya pemain liga taktik mentok hadehhh gimana mo maju kalo kalo masuk piala asia aja bersukur	negative
arhan bagus kasih crossing asnawi nonton doang press pemain	neutral
nyembelih anjingnya	negative
offside goal iran	neutral
sii	positive
asli dah pemain indonesia butuh latihan passing	neutral
fr tolol	negative
mendadak pelatih sattt	neutral
refree gajelas anj	negative
semangat indonesiakuu	positive
rafael ra masok blassss	negative
kalah dewangga	positive
asnawi kaya buta map ngikutin garis bek belalang mulu	negative
minimal mainkan sananta lahstrekee ngotot ktmbang si struik	positive
admin marcelino pencetak goal termuda piala asia kemaren kualifikasi pencetak goal termuda	neutral
struick bench	positive
aadin sundulan offside	neutral
ivar lini tgh auto kocar kacir	neutral
beruntung irak bermain buruk smnagt pejuang timnasku	positive
berani presing pemain indonesia ngotot jordi blunder mulu contoh goal irak blunder	negative
mending gaya ngegolin bang bacot doang	negative
asli linglung	negative
lesgoooo garuda babak allah allah nontonnya	positive
next sandy shayne wajib starter	neutral
komennya jaga guyss berjuang semaksiamal indonesia kritik mbok	positive
yakob rafael	positive
nii kwkwk	negative
babak barud klarifikasi kali jdi protes taulah nunggu	negative
kelas piala askab rejang lebong gar	neutral
ayo bangkit babak	positive
kebanyakan nahan bola admin yauwis atuh admin sabar bae berharap perubahan dibabak tetep dukung pemain	positive
timnas butuh haaland sbg predator lini	neutral
var e goblok	neutral
okenzo dunia	negative
fix salah line maksain main pakai bek hasilnya hancur kreativitas main bek inget coach bek sayap kiri kanan marcelo dani alves	negative
tolong jordi rafael struick ganti kaya tenang mainnya	neutral
bang disuruh gantiin struick	neutral
offside goal iraq gunanya var	neutral
ayo indonesia	negative
ayo garuda	positive
wp nyundulnya pakai rambut doank wasit offside wkwkw	negative
semangat garudaku	positive
minimal kalo naturalisasi lihat permainnannya asalan	negative
mainnya lumayan bagus asa menyamakan kedudukan goal haram iraq	positive
pertahanan jelek indonesia	negative
anehh emangg	negative
tulung pemain asing kayak tenaga lemes senggol dikit jatuhh	negative
orang indonesia	negative
berjuang garuda bersamamu terima kasih berjuang lambang dada	positive
aji amin	positive
wasit kena amplop kelakuannya	negative
keren usia muda perlahan permainan bagus sepak bola indonesia konsisten	positive
asnawi marklok dimas dandy tolong jngn bawa timnas layak	neutral
yukkk leg semangat garudaku	neutral
struick loyo maennya kya penyakit ajalawak badan loyo dipake main bola	negative
makassar wayaaaww	positive
kesalahan sty memasukkan witan menggantikan witan sandy walsh masuk witan	neutral
struick asli loyo lemes bnr maennya bikin ngilangin tempo permainan pdhl bagus tdi peluangnyangpasing delay trs jdi kecuri kn bolanya	negative
kesel hate aing mah gusti	negative
yuuu comeback	positive
bang offiside	negative
realita ranking terbawah afc netizen indonesia ekspetasinya kyk indonesia rank teratas afc pasa ngehujat mending bantu motivasi pemain ngedukung mending tangan diem pda dipake ngehujat negara dihujat sdmnya yukkk	negative
witan main kaya mencrett	positive
ampas	negative
akun asli bales pernyataan bre anti kritik banget kocak	neutral
terimakasih garuda muda	positive
bkn wasit var ngecek gmn njir keliatan segitu	negative
asnawi menit ngapain anjingg asnawi kapten ter goblokk dunia passing salah mulu duel bola kalah bener gunanya	negative
sananta main	positive
coash sosmed perkiraan gor iraq sah opsait	neutral
ofsedddd prittttttt	negative
kebobolan bro td offside	negative
kesel lihat	negative
main eweh perubahan	negative
tolong pendukung timnas kritik pertandingan babak kesatu pertandingan pesimis laga pembuka	neutral
negara asia tenggara sekuat asia lainya afc negara asia tenggara perlahan lahan menunjukan perkembanganya	neutral
sty ganti pemain	negative
harrss offside	negative
nunggu kualifikasi pildun ntar mah maennya gimana ngeliat sty milih komposisi pemainnya hancur cok anak emaskan	negative
yakob	positive
semangat timnas	positive
offside	negative
murni striker bang sayap produktif sebenernya	positive
andai couch melatih timnas indonesia berubah	neutral
berat nurunin sandy	neutral
asnawi	negative
udah kendala butuh striker kuat lindungin bola jdi pemain buka ruang cari peluang striker skrng jdi posisi pr kdepan	neutral
ribut ajig offside cooook	negative
seri ayo garudaku	neutral
ayo bangkit garuda seri lawan nguyen wajib menang	neutral
offside goal	negative
gok irak hrs diprotes pssi udah jlas sblmnya bola umpan silang brhasil diblok ernandoposisi pemain irak offsidesgt skli	negative
struick letoy amad anak mama	positive
marselino keliatan banget kosong striker aduh	negative
asnawi titik lemah timnas lewati pemain irak serangan irak pling sisi kanan timnas	neutral
reno netijen kayak gini bikin maju	negative
bagus jelek netizen indonesia asa	negative
boaz kalo dah behh obat bang	negative
duh ampun dah maennya grasak grusuk	negative
offlside goal woiii	negative
main gini masuk pildun wkwkw	negative
emang mainnendang bola syukur kli	positive
pantek wasit nama akun wasitnya dah carik emang dah kena pala	negative
tolong komentar selesai main	neutral
terima fakta kalo asnawi habis cukk	negative
marceng dikasih postingan goal	negative
berbenah	negative
wara gratis langganan	neutral
kritik timnas coba main sono bukanya dukung hujat kocak	negative
coba main bang untung bayar goal	positive
cheuuuk	positive
bgus maennya cmn sayuri	positive
masuk grup telegram link	neutral
jujur main indonesia berubah drastis uji coba kmaren permainan berkembang bagus pengalaman kematangan pemain kalah level banding iraq lawan vietnam wajib poin	positive
offside bro goal umpan silang offside	neutral
kakean cangkem raimu iku pendukung karbitan bolo towel ae	negative
wasit pekok offside biarin tambahan udah	negative
wita giring bola umpan umpan main operan nunggu individu biar sorot gimana	neutral
live kk biar bsa lihat	neutral
gobloookk nyuruh orang main	negative
uh	negative
gini cewe	negative
komen gini merusak	negative
trio macan masuk matiin tv	negative
dendi	positive
p	positive
lihat lineupnya bek gimna nyerang	neutral
besok starting line gini terussssanak kesayangan dicadangin	negative
pemain jatuh kena kaki mnjdi umpan nyundul nyundul sblm udah posisi offside	negative
terserah bilang faktanya pemilihan pemain pengganti sty tolong carikan pelatih kualitas diatas ganti	neutral
cari kesalahan orang makan bro nitizen	negative
next match danu karo bagong pasar wae duet ne bek	neutral
mangkok layak senior	negative
asnawi ganti sandy bang kelabakan mulu sisi kanan	negative
ijonk awakmu yo due cokngopo umbarne jeneng barange lanang risih rasane	negative
indonesia kalah	negative
unknownx tetep goal keputusan wasitnya	negative
bener maej pas ujicoba kayak bingung	negative
coach shin like lino linooooo smgt²	positive
kena pala bang	positive
piala asia piala aff bersyukur bangga indonesia	positive
side resmi fifa wasit buta map	neutral
adinda dimas miss bolaitupun backpass akuratbukan passing lawak lawak nonton dimensi	neutral
mainnya panik bos isi goal	negative
dipp ehhh awas bang disuruh qatar	negative
mainnya keren melebihi ekspektasi	positive
pertandingan cuy greget mahhh	positive
vizcarra main	neutral
setia netizen bacod	positive
mantap garuda nonton piala asia nonton piala dunia	positive
elkan meningkat	negative
greget sie	negative
sananta si bang cocok	positive
inget katakata luis milla pelatih menggaransikan juara berbohong	negative
bek coba main udah ky liga tarkaman seneng seri babak kegolan	neutral
asnawi ganti	negative
post sebelah komennya jelek jelek banget gilak tega tega ngomongnya	negative
fr perasaan drtdi bagus pemain keturunan	positive
lucu permainan indonesia match luccuuuu	positive
kaya gabener main bolanya menit diserang terusbosen nntonnya kalah mulu	negative
rudettt rudett	negative
taru tugas nitijen indonesai mencari menghilangkan instagram wasitnya	neutral
iyee paham ngab	negative
arhan cuman jdi pelengkap tim	neutral
iso maido	positive
offside	negative
bully pacar yaaaa	negative
asnawi main	negative
si bisakocakk	negative
alvaro irak suuga ngerti yablajar dlu sono	negative
ayo kebanyakan individu ayo kerja	negative
jancok buta sty posisi asnawi rapuh	negative
cosplay dandy	positive
semangaaaat garudaku	positive
sty	positive
makassar ewako	positive
smoga kebayar	neutral
striker gatel	negative
si kalahnya	negative
var kuprettttt offside koq	negative
main kyk sampah gtu prlu diapresiasi	negative
alhamdulillah peningkatan kmrn kalah skrng bersyukur mah msk piala asia udah alhamdulillah semangat indonesia argentina kalah diawal pas bawa pulang piala	positive
good game bro lets kasih keras	positive
mending jual monitor kesel ajg	negative
nr udah dinyatakan goal sahh cuy	negative
wasit nggak var nggak dipakai wasit curangi indonesia	negative
allahmdhan timnas kt menang mlm hr setrusnya amin	positive
rafael ganti	neutral
tolong wasitnya edukasi goal gajelas	negative
lawan vietnam japan wajib main habisan urusan menangkalah	negative
permainan timnas indonesia bagus dicaci maki netizen indonesia ampas doyan nyinyir perjuangan anak bangsanya mengagung agungkan sadil ramdani mengikuti skema taktik pelatih witan marklok jordi kambuaya dimas drajat dipake indonesia kehabisan pemain berkualitas selevel asia kalo menyalahkan pemain liga dipake salahkan pengurus liga indonesia pemilik klub suporter klub barbar mafia bola pemain liga	negative
terbukti struick kakean ngemut ball	positive
keren mainnya tinggal var dicek	neutral
kritik mhzz pantes bacotin ngebacotin komenan nyruh main	negative
plisss maenin bola disekitar gawang langsung buang trauma sosor irak	negative
offside mh jir	neutral
passing jordi timnas indonesia memanfaatkan sentuhan sprint kedepan	neutral
semangat garuda maluin segini keren babak	negative
wasit liga pinggir gawang	neutral
wasit jabingan	negative
info akun wasit	neutral
kayaknya offside onside kalo layar kaca sekilas offside var pakai taru onsideoffside	neutral
ayo garuda	positive
ngerti pergantian coach shin memasukkan witan mengganti asnawimenurut fatal soalnyaokelah asnawi kuat main mending gantinya sandy walshkarena witan masuk efek nyaapalagi dimas drajad main turun performa	negative
var berguna	positive
kasihan sandy dikit dikit anak mas grasak grusuk dimainkanout sty telek deh taiiii	negative
terburu buru	negative
menit	positive
witan astaggaaaaa kebanyakkan gaya	neutral
wals mainkan	neutral
maklok permainan jelek	negative
semangat garuda pertandingan berharap sandy kesempatan bermain	neutral
evaluasi coach bek kiri tolong ganti pemain bagus pattynama bek kanan pasang shandy walsh	neutral
offside cuk	neutral
nge kritik ngehujatgaada ngelarang ngekritik larangan ngehujat	negative
njs lo	neutral
sananta masukin ganti struik admin	neutral
contoh yakob sentuhan sentuhan eh habis anjlok mainnya	negative
f woyy pantekk	positive
pujensco top	positive
top	positive
coach online persilahkan	positive
level timnas semangat garuda	neutral
info wasitnya cok offside	neutral
coach sandy walsh dicadangin allah gini mainnya astaghfirullah	negative
fr pelatih pemain naturalisasi jordi rafael goblok dah	neutral
bol witan	positive
iqbal kritik sty kontrak seumurapapun korea pokok bestkorea korea korea korea	positive
admin pelatihmu mikir nyusun pemain sandy walsh dicadangkan dimasukkan bagus berduet dgn yakob sayuri kanan saran mainkan sandy shyne utk pertandingan hubner diganti sm klok kambuaya	neutral
pemain kaya witan udah timnasplease buang nih pemain mutu	negative
buyar wes permainan e	neutral
opsetttt	negative
semangat garuda	positive
aslii	positive
gooooookkk	positive
vidias betulll varr	positive
tiati mang diserang fangirll struick	neutral
sayang banget mlm ramadan sananta mainkan coach	positive
ngapain jelass	positive
maklum indonesia kalah pas main peluang hrsnya goal pemain memaksimalkan peluang pegang bola	negative
posisi nyerang bang onside offside paham sekilas emang offside gatau var	negative
ngehujat pemain udah berjuang semaksimal netizen kerjaan cuman hujat doang menang seneng ketawa ketiwi ngehujat nonton bola kick	negative
hujatanmumotivasikuu	positive
pulang indonesia lahh	positive
protes hbis pertandingan afc fifa laga udah cel var offside dilanjut	neutral
ganti pelatinya plis pemain sebagus sandy shayne camat lawan irak gila	neutral
ber ekspektasi kalah ngamuk ngamuk	negative
update skor admin takut dirujak netizen	negative
halahh bermuka	positive
wasit fans barca	negative
var cuman pasangan fungsi samasekali	negative
yok yok garuda ayo	neutral
arhan main jepang tibatiba timnas wkwkw	neutral
dihujat si sty tolol	negative
blunder parahh	negative
timnas tim termuda dg usia th diatas vietnam jepang jngn dibebani dg target tinggiapapun hasilnya support berkembang th	positive
driblang dribling	negative
arhan dicamattin ditimnas passing becus tenang grasak grusuk milih shayne	negative
coba duetin egi witan	neutral
coba suruh gantikan lbh jago	positive
ganti woooeee bocah cungkring nan ringkih nomer main koyok giatel iso sat set blaasss	negative
perbanyak shalawat ummat rasulullah saw indonesia	positive
ayollahh netizen budiman indonesia uda ajang terbesar asiaa masuk ekspetasi kirai lawannya timor leste okelah bisaa squad termuda piala asia lawan uda senior kedepan bicara asia ditambai pemain keturunan banyakjuga uda bermain paham bermain ajang kebanggaan tolong kritik membangun pas menang koar koar ajak argentina rematch kalo kalah serbu akun instagram norakkk	negative
ngerasa performa menurun pemain semangat juangnya ayo garuda bangkit semangat next match	positive
tolong jelasin goal irak offside	negative
var anj	neutral
tega liatnyaamending turu besok pagi kerja	negative
lihat noooh kebobolan noh dek sok tauu bacot	negative
rafael jelass uda ngerti lemes starting	negative
witan good game	positive
main bertahan nunggu bola kehabisan stamina	neutral
marck clok cuman ngebawa tim ngacak	negative
udah dihujat timnas berjuang males banget ngeliat komentar ngerendahin timnas jiwa nasionalisme anj	negative
aadin sante report akun wasitnya	neutral
sananta ngamuk	negative
nntn selin bikin nangis bikin seragam jantung blh berharap rada mustahil	negative
yall comeback gasinnnnnn	positive
nice try timnas	positive
amin indonesia menang cetak goal kebobolan	neutral
ngarep timnas cuy dukung	positive
var becus kmrn goal cina masuk anulir offside anggap offside giliran goal iraq offside goal kocak var tarkam	neutral
goal salah rafael si	negative
mending hps	neutral
premium	negative
haii wasit online gmna goal irak	neutral
menikmati rumput qatar hawanya pgn plesetan	positive
ndapatady alay bang	positive
kusumapurnama dukung	positive
yok yokk semangatt lagiiii bisaa yok ngimbangi	positive
kalah patut apresiasi komentatornya bahasa inggris berkali kali bilang match intensitas permainannya seru diakui kesalahan elementer	positive
kowah kowoh	negative
sananta murni mainkan	positive
jordi gantiiii please	negative
parah emg mending sananta	negative
ayo	negative
hubner gelandang kambuaya	neutral
asli offside asli dah	neutral
lagiiiii	negative
ofsed cokk jngn ngadi nagdi laa	neutral
var becus cok	neutral
hujat hujat kritik membangun main piala asia prestasi tersendiri ayo garuda terbang	positive
pelatih online nih	neutral
sang kreator yakub sayuri	neutral
marss pengen indonesia menang pemain bikin kesalahan hate comment semangat gimnaa menang gtu	positive
fightingggg	negative
bang abang nonton sport tv	neutral
bagaskara kayaknya bola umpan ny kenak sm jatuh	neutral
semangaaat kawan² dilarang membully pemain pelatih official mari dampingi support timnas	neutral
ka cek var	neutral
semangat timnas terbaik	positive
apalah sandy walsh mainkan mulu	negative
udah keliatan pas kualifikasi piala dunia rapuh bener sisi kanannya	negative
umpann yakob topp	negative
ayo jaga jari jemari kalo hujat berlawan arah babak k bagus puja jngn jdi bunglon dukung semangat	positive
gurl mbaknya nonton gregetan lihat struick main	negative
ankara sayuri	negative
syahrizon bnr si apresiasitapi kesel sma si struick loyo bener badannya penyakitan	negative
makassar kece permainan	positive
yacob sayuri bermain lepas bek indonesia blunder dikit kehilangan bola	neutral
rafael struick	neutral
mata pakai wasit	negative
offside var ajg	neutral
coba cek	neutral
takut bola berani fight miss komunikasi	negative
asnawi sandy	negative
percayalah kedepan tim menguasai asia	positive
garuda maju	positive
nzl ngeri banget mainnya	negative
main mabok kecubung bro	negative
sandy walsh kalo starter pindah liga korea	neutral
f weh binatang elu orang	negative
bro	positive
info instagram rame rame rt report	neutral
taeekk	positive
kakean batagor kw ndes syuk maenmu sumpah bosok banget sadar po rak jane wkwkwk jengkel guyu hahaahhaahsyuuuuu	negative
komennya hujatan mulu emg sempurna goal	negative
fb lambe turah neng komen	negative
ampun si taru bola sungkem suhu	negative
var kalo wasit berat sebelah	negative
bang habis piala asia teken kontrak	neutral
wkwkwk bacot paham bola ngerti pemain mending diem	negative
bangga sii hadir timnas turnamen piala asia	positive
asnawiklokkambuayawitan apasih	positive
kontribusi lolosin timnas afc	positive
njir var offside anj	neutral
ngehujat main kahh udah nonton gaush berisik	negative
asnawi kapten oleng	neutral
bubar buar	negative
lol ah umak	negative
serang wasitnya kontroversi goal ketua irak	neutral
kl opini kl diliat dr posisi offside emg posisi lari niat nyamber bola kena sundul	neutral
var cadangan doang	neutral
mexslik	positive
netizen rohingya	negative
bang	positive
rafael ganti sananta	neutral
bener	positive
fakta mah fakta ajagaada urusan sma fake	negative
gaada upaya ambil bola pemain iraknya penilaiannya onside	neutral
smpe skrg blom post ft admin indonesia	neutral
strujick gajelas ngentod	negative
indonesia mah bola muntah buru buru buang gocek pertahanan kandang musuh kali goal	negative
fak tehwkwk	positive
bener sandy wals masuk gantiin struick wkwkkwk	negative
id kasih tutor admin	neutral
bagoy klokk lord	positive
si pandangan mimin	neutral
ayokk pertandingan optimis menang semangat	positive
blakang rapat man man jalansaat lawan pegang bola garis serang pemain kuran cepat menutup gerakan lawan pemain santut serang cari aman bola pertahan semagat kompak	neutral
sandy wajib starter	neutral
ngerasa zolimi var	negative
gajelass bocah tengil gocek gocek trusssss blunder	negative
ngotot doang keeping dikit gedabrukanmalah nabrak terjungkal	negative
sdm piala aff piala asia mimpi masyarkat kritik halahhhh kei hiburan hiburan e bacoti dewe sdm gblk	neutral
f bjir rohingya	negative
latihan doang menang kwkwk	negative
uda offside pemain irag uda nyundul var	neutral
yogaa sananta cedera	neutral
sida ntah gimana	negative
pasang bek kocak	positive
pendukung karbitan komen tidur ae butuh bacotanmu	negative
ngop	negative
please ivar tarik yakob biarin kanan	neutral
cek par	neutral
nice	positive
asnawi mudah ketipu gerakan sederhana	negative
cok	positive
offside anjinkkkkkkk	negative
udah mah jdi beban negara beretika mas² banyak²in ngaca biar taru	negative
f netijen kayak gini bikin maju	negative
aaaaaaaaa kasiann aaaaaaaaa	positive
ayo serbu akun ptotes rame² disana	neutral
var kaya gtu gilaaa gilaaa astagfirullah	negative
kalah menang kudukung permainan ok kurangi blunder semangat garuda	negative
tolong asnawi pakai	neutral
ngapain si tukang makan mie masukkk	negative
fachrizal sok ngerti maenpandai engga	neutral
info instagram wasit ngabb	neutral
oke intinta imbang	neutral
rugikan indonesia	negative
iyaa cmn kesel lini nyaa cmn yakub menonjol	negative
coba ngerasain st tunggal bng	neutral
nagami banget cok asli buta map anjg	negative
ganti drajat	negative
semangat garuda	positive
misteri starter klub eropa menikmati permainan menit hahahah	neutral
sty tolol	negative
gamasuk line aneh	negative
ngerti kualitas blm level itubanyak evaluasiakan nilai daya juangnyadan berterima kasih daya juang semangat timnas gafud	positive
pecat pelatih timnas indonesia sin tae young ganti pelatih lainuji coba kalah ajang resmi piala asia hajar irak pelatih sin tae young warisan ketua sebelumx muhammad iriawan	neutral
kembalikan luis milla blum dpt permainan enak diliat pemain natrulisasi dikasi skrg	negative
must height ideals	positive
gacor pas debut mlempem pas piala asia	neutral
witan cocok timnas main lepas dapet bola lepas² kambuaya ego cocok taktik shin skrng asli	positive
nraini ehh datangg	negative
offside	negative
cari gelandang klok kambuaya istirahat timnas	neutral
buset sundul pergerakan	neutral
terlepas hasil percaya coach membangun tim	positive
main gantiin si	negative
fr bang jordi bagus club	positive
struick outt	negative
trlpas emang lino dulukan emang suka mainnya boskomentator bilang gimna dnger kanya rmang bagus proses golnya trlepas fokus prmainan bos	positive
jordi ganti kebanyakan blunder	negative
ayo gassss kang semangat²	positive
sty setuju ganti pelatih belanda	neutral
blunder sdh tua	negative
offside	negative
rafael underfoom	neutral
ayo	negative
dendy main	neutral
yok yok balas dendam minimal imbang pliez lawan kuwait yok nyerang bismillah	neutral
fungsi witan yakk	negative
tap top tap top emang gaboleh kritik bre anti kritik dunia politik namanya kritikus gaboleh kritik jadikan kritikan pemicu biar lembek kocak	negative
next sandy shyne kudu starter klok asnawi harapan	neutral
witan dendi sty salah panggil	neutral
setia bodoh banget sumpah ganti sm pemain bench	negative
join ayo	positive
struick	positive
info skor	neutral
yok	positive
ko disahin	negative
makassar sayuri bersaudara main gacorrr	positive
permainan babak josss semoga babak comeback menang amin allah	positive
var	neutral
istimeway sty cok miskin taktik dipertahanin bek versi maguire kiper oon berani kandang bola pasing bisanya bengong nunguin bolaa dipertahanin ancuur bikin malu	negative
struik cok gregetan udah capee keliatannya striker masukin dendy	negative
si realita ambil lisensi bang pelatih online bakat sayangkan bakat pelatih online	neutral
lmnfds var fair banget	positive
udah admin sni bkn rna capek aja ngoceh mari fokus mencri sunset yng mnjanjikan kepuasan mata hati isi kepala	positive
rapuh bat bgian asnawi	negative
coba lihat pemain nyerang sisi kanan jalan buntu sisi kiri kosong bola miss marsel struick next match serang lini kanan kebanyakan egois pemain lini	negative
fachrizal asnawi rafael	neutral
ganti si asnawi	neutral
taru gawang oleng kayak orang mabuk mending taruh sayap	negative
berpendapat lihat pertandingan indonesia vs iraq pemain geraknya bola diem cari ruang sngat berbeda vietnam vs jepang pemain timnas vietnam gerak faktor umur pengalaman alasan marselino gawang gabisa memanfaatkan peluang mohon buang jeda sblm terlambat biar proses lihat sty stuck pergantian pemain blunder pemilihan striker mnrt	negative
kalah lawan irak menang lawan vietnam seri lawan jepang	neutral
walsh wajib main	neutral
striker mandul bawa pulang negara asalnya	negative
keep strong	positive
nonton dimana bang	neutral
diem bego main bantu lihat buktinya ce	negative
lihat lawan vietnam starter arhan asnawi sandy pattynama ngerti	neutral
hujat orang berjuang negara sdm indonesia	negative
main ngantuk pegang bola bingung	negative
marcelino payah	negative
robot kuat kocak	positive
nyundul pemain iraq offside banget posisi	negative
please coach pattynama ramadhansn starting line match vs vietnam r dont play	neutral
keputusan wasit mental	negative
bismillah comeback	positive
sakit hati putuskan cinta indonesia kalah piala asia	negative
tutup komen teruss takut kenak mental	negative
nyata real ja passing tiab lapangan hancur	negative
mending witan false nine	neutral
makanyaapinginnya menang gapernah support ngehujatgmnaa smgtt support siapaa lagiii	positive
wasit dongo var cok	negative
keliatannya panik fokus blm tenangitu pandangan yaayo semangat timnas	negative
lihat tdi sisa sandy main gila sandy setenang jadiin cadangan	neutral
opo iku stuck kocak	negative
makassar sayuri	positive
asnawi ngapain	negative
kangen lord fachrudin el capitano sesungguhnya	neutral
masokiiii sananta	negative
beknya grasak grusuk kayak kebagian panggung	positive
klok witan dimas ricky masuk enak mainnya	positive
admin ko post ht	neutral
dibuang kagak pindah gaji nunggak	negative
offside	negative
lihat pas qualified piala dunia kemarin kemana bodi jatuh suruh ngefres sprin	neutral
rafael struick suruh istirahat mandi bobo	neutral
cok tetep bang hujat diwajarkan ngelunjak minimal kritik membangun hrsnya	negative
next time lawa vietnam line nadeo jordi husber riski rido banggot patinama wals asnawi arhan wahyu pras edo jamin menag lawan vietnam	neutral
fungsi sandy walsh pelapis asnawi	neutral
ayok netizen netizen mampirr rame nih	positive
setuju goal marsel gocek	neutral
pliss yokkalian kalah goal offsidebabak main timini ajang kehebatan individuyok kompak	neutral
wasit jembot	negative
wajar td emg egois nge golin	negative
terbaik ngehate main bola	positive
wasit kocak gilee offside malaj lol	negative
bener banget	positive
makassar kelaazzzzz	positive
bodo offside struick ngapain yaallah hem nangis liatnya	negative
timnas perlawanan woyyy	positive
salam babak pemain liga lokal masuk acak kadul tengahnya	neutral
var bulshit	positive
asnawiii kunciin cok wc qatar	neutral
pulang sty ngehargain pemain membela indonesia dicadanginpadahal sandy tulus bela timnas kalo tulus berjuang dinaturalisasi	positive
adiansyah sandy walsh bagus sayang telat	positive
live dimana	neutral
jy yoi asnawi titik lemah semenjak kualifikasi pildun gampang lewatin	negative
pliss coach dengerin kali	negative
emang faktanya ekkw	negative
selebgram	positive
namanya berkembang	positive
struick main grasak grusuk banget allah tenang lepas coba main santai press habis abisan main kalem	positive
pelatih berhak nambahin pemain butuh perawatancideratoh cma detikklo ofside gtw	neutral
aduh coach² sandy walsh make bocah grasak grusuk asnawi gerobak	neutral
yakob sayuri kelas banget dribel	positive
sandy walsh dimasukin yakob suruh wingbek aneh sty	negative
f duh bisanya pengungsi	negative
sanantaaa keluarinn sanantaaaa	positive
main ntar obok obok	negative
good job man	positive
komen pelatih nggk maksimalkan potensi pemain	negative
sananta dongg cadangan mulu anjirr	negative
kenyataan ganteng salah ketutupan real indonesia	negative
aadin tolong bang awam knapa dianggap offside	negative
taru witan kali pegang bola	neutral
sdm rendah	negative
real offside kocak var wasit	neutral
sdm rendah miris	negative
rafael stuck tarkam anj	neutral
dimas masuk menit main menit lari	neutral
stwan mental turun pas indonesia masukin goal	neutral
rbtv liatnya chrome	negative
king indonesia ngikut jepang kemaren sempet kalah lawan vietnam habis kombek	neutral
kalah hasil match ft sgr post post menang abaikan netizen menghujat bs ditutup kolom komen admin berani bangsa pemberani pengecut	negative
setia mending budi sudarsono bang	positive
emang post full time	negative
elkan ganti lh	neutral
makan asnawi lesu banget	negative
terimakasih coach sty engkau berhasil membawa timnas permainan menarik dimainkan pemuda hasilnya kemenangan proses sungguh bangga teruslah berproses garuda	positive
offside goal irak	neutral
hipotermia curang cek var perhatiin	neutral
ayo guyss hancurkan vietnam	negative
offside si serius dahh posisi masuk duluan rada curiga nihh wasit var thailand hmmm	negative
asli kesel liatnya emang kali bagus cuman kaleman dikit prasaan lawan garnacho udah bagus underperfom kaya gini bangke	negative
emang neti	positive
struick hebatnya hahahah	positive
batik malaysia	negative
goal offside co gunanya var	neutral
nraini	positive
sandy wals starting kaka	positive
nadeo pasang	positive
fr muka	negative
goal k irak kontroversial parah neh wasit	negative
tolong asnawi diganti sandy walsh bagusan mainkan asnawi	neutral
bagus permain sandy babak asnawi bagus kali bro	positive
blokkk	negative
muluk imbang deh	positive
kalah irak	negative
pleeeeaasseeeee	positive
goal irak sah wkw	negative
gar cek orang belom	negative
indonesia skill individunya detik langsung lepas bolanya	neutral
juru kunci	negative
kalah mulu	negative
main simple gocak gocek	negative
si rafael	positive
netizen indonesia menghujat	negative
klok masuk permainan hancur	negative
nur gapapa membalikan bang	neutral
lawak ngapain dimainin dah	negative
salute penyokong indonesia qatar dengar sorakan indonesia masyaallah terbaik disana salam tahniah malaysia	positive
benerr bngett offside pdahal	positive
cari instagram wasit	negative
wasit slh njir offside kabulammak babak prtma bagus banding babak njir	neutral
bener larinya kenceng ngejar bola kalo dpt bola dpn gawang kaya kebingungan suka banget kepung lawan	negative
semangat	positive
semangat garudaku	positive
semangat garuda sandy walsh dimainkan	positive
sabar msh babak msh kalah gag namanya pertandingan menang kalah kalo menang trs gag prnah kalah namanya cewek	negative
komentator australia suka bloon bang	positive
offside brani nanyain wasit konoha var blunder cek kyk	neutral
masuknya witan merusak pola permainan pemain males	negative
asnawi sandy sty	neutral
top komen wajib pin nih	neutral
asnawi cok kapten oleng	neutral
rafael asik	positive
shen tai yong pride	neutral
firaa	positive
ganti rafael main nga kehilangan bola mulu	neutral
offisiteee goal njirrr	negative
r bener ajeeee	positive
rafael struik	positive
habis kebobolan	negative
beban tim	negative
rafael seblakk km raspot mo padang masyar	neutral
alvaroo serang instagram wasitnya banggg	neutral
delay sihh main sempet error skor ehh beneran	negative
timnas butuh support oi hujatlagian babak	neutral
tolong asnawidirimu grasak grusuktenang dongg	negative
witan	positive
assalamualaikum instagram afc	neutral
bener ye wasit kena azab masuk gilingan semen sit	negative
babak optimis goal	neutral
tim butuh pemain ganas yakob sayuri irfan jaya fajar faturohman lilipaly ricky cawor pemain tipe bertahan main deni	neutral
kalah menang indonesia menghujat mendukung	negative
keren marselino top sayurii	positive
struick ganti wahhh rak masuk blas ujung tombak kyok ngunui ki opo	negative
ayo bisaa yokk	neutral
baggott ganteng banget	positive
babak masukkan sananta rafael	neutral
boleehtidak tdk mungkinn ewako	negative
bilang jordi koq gtu	negative
ea kalah caci mininal makan mie	negative
offside goal irak	neutral
bismillah gaspoool semangat adikku ganteng² semoga timnas kesehatan kekuatan keselamatan menang amin yra	positive
pemain timnas kalo pas bola pegang sturick pasrah ilang pegang bola nggak ngapain mendingan sananta	negative
gini bang kalo afc posting spam offside	negative
senangku sebentar doank	neutral
pemain indonesia suruh belajar passing nahan bola	neutral
bnerr	negative
udaa ajaaaa	positive
komentar sampah beradab pakek mata lihat jelasdia manusia ngotak dikit berusaha gosah bacot main tinggal nunggu hasil	negative
asisten wasit becus offside	negative
bang	positive
pulangkan witan klok	neutral
semoga berjaya indonesia	positive
pep guardiola jose mourinho puyeng latih indonesia	negative
fathh buru berak kali bang wkwkwk	negative
rafael berkembang	positive
sandy walsh shyne pattynama dimainin asnawi arhan heran	neutral
var gx	neutral
sty salah memilih pemain	negative
parahhh	negative
update score half time full time menang kalah dicurangi update story doang afc cup update postingan ujicoba update postingan	neutral
offside cokk second goal irak	neutral
muka	positive
serang wasit var	neutral
mati	negative
beda kelasya berusaha apapun hasilnya terima berjuang piala asia harap berharap pas lawan iraq kandang situ thom haye jay idzes banget ivar tandem justin cb	positive
var kacauuuuu	negative
asnawi diganti witan	negative
tolong banget mah yak main simpel babak fokus plis bisaaa bisaa	positive
yakob obat	positive
asnawi pliss	positive
nahh bener bray	positive
offside goal iraq	negative
sit offside lho sit	negative
heran lihat ngukur lapangan	negative
always juru kunci	neutral
berharap kalo mainnya kasian	negative
semangat kendor balas babak	negative
pemain overrated pengen show kebanyakan gocakgocek gajelas tal	negative
blunder mat mat	negative
mbok paham kemampuan e dwe cah njuk tolong support ra meng maido	neutral
rcti	negative
main tiki taka main main bola kaki kaki main main santai main lepas main pede indonesia	neutral
yok optimis peluang indonesia	positive
sundul bang	positive
marselino udah capek ngegolin lini pliss main aman klau ragu dibuang gocek	neutral
kak berkomentar negatif ttap dukung timnas	negative
pemain	positive
yaudah timnas keren mainnya rapi bener kesalahan golnya murni beruntung irak	positive
sananta hrsnya bw irfan jaya sayap obrak abrik	neutral
gar offside	negative
ngeri bacotan suporter ngerti bola kaya udah sekelas messi	negative
change pelatih	neutral
netizen mohon doanya ghibahannya	negative
ditunggu kemenangan	positive
kamii bangga lanjutkan bersinarr	positive
awkwkwk kocakk	positive
salah mnurut jordi baggot jordi blunder mulu baggot gabisa tackle lawan tackle gaakan goal	negative
wooiii kapten gunagak berani nekan wasit	negative
marcklok always played even though often lost ball especially passed ball wrong dimasdrajad even though sananta actively chases ball good control indonesia whatever result keep supporting watching end	positive
plis mas mas nomor istirahat babak	neutral
saran elkan dicadangkan diisi hubner posisi hubner diganti sandy	neutral
ref var	neutral
lini pr coach	neutral
ndapatady si caper berulah	negative
ketik google beinmacth	negative
syahne sandy inn	neutral
pakai vpn server belanda nonton channel asia cup	neutral
beneran indonesia mah main liga tarkam asia asia asia khusus negaranegara mental juara	positive
mmy	positive
need sananta	negative
fokus kasih keras	positive
sia sia nonton mending nonton liga	negative
suka dibawa bolanya main umpan cari ruang kosong ngelewatin efektif press panik semoga babak tenang biar passing permainan berkembang	negative
bobolan	negative
still many things lacking	positive
puas kinerja bagus malam pelajaran ditarik menjaga kedalaman lini pertahanan semoga bergabung lini motor serangan sayuri libas skor minimal mengejar defisit goal menahan seri perubahan susunan pemain strategi mengikuti game plan insya allah bismillah allahumma shalli alaa muhammad waa alaa ali sayyidina muhammad mari langitkan shalawat badar	positive
rill bang ngapaa	positive
rafael ngapain	negative
kelazzzz bang	positive
ayo bully emosian napa dukung kasih doa kuat tanding blm tntu becus	negative
bang suport indonesia	positive
asnawi uda digantigimana bosapa bosdiganti asnawi jebol	negative
offside gasi	neutral
kalah menang kudukung ayok timnas indonesia kalah kudukunng menang kusanjung ajang aff kalah viatnam jepang	negative
gila ivar hubner	positive
banyk ngocek	negative
makassar salah bawa orang	negative
bismillah menang vs vietnam	positive
sherlock bos	negative
neng neng emang fakta bapuk main gimana blunder passing masi salah salah wajar kalo kritik biar membangun si pemaen lembek	negative
berdoa berharap semoga sandy walsh pasang pas lawan vietnam semoga sty kesampingkan anak mas meraih kemenangan	positive
menghina visi permainan bingung bagus main bali united guling menang	positive
setiana ngegolin	positive
var rusakkkk	negative
konsisten kalahnya bagus wkwkwk	negative
pelatih online bermunculan	negative
goal indonesia jujur murni kesalahan back iraq doank posisi marselino pas banget nerima umpan goal banget kesalahan pemain iraq maju garis lapangan pas bola timnas main possession counter kayak lapangan kosong gawang lawan mainnya press banget pemain lawan mesti kecolongan bek sayap ayo coba main possession	negative
yaelah laga uji coba doang diseriusin sty sengaja ngalah biar taktiknya kebaca piala aff penyepong bintang iklan kopi	negative
iqbal kayaknya udah kodrat suka hate comment	positive
asnawi	negative
habis pikri sandy turunin mnit trakhir pas kebobolan turunin aneh bgtv	negative
bener ajaa half time rugii dongg	negative
rafael	positive
ayo sandy please	neutral
rafael struick gajelas banget emang anjeng banyakan gocek tai	negative
bikin blunder lini sbnerny ksihan diblakng	negative
terhitung offside bang bolanya jalan	negative
main main jepang vietnam	positive
capek	negative
real bang overrated shoot shoot oper	positive
sante akun wasitnya report	neutral
var cuman lihat replay vid sekilas doang lihat zoom hadehhhh	negative
ganti jordi anat	neutral
lmnfds wasit ngecek var	neutral
bilangin mainkam rafael struickgol gara gara diaga langsung buang depanndia lapangan cuman adu sprint doangg allahbudeg pemainnn	negative
cok greget bngt lihat	negative
goal offside	negative
pertahanan sisi kanan kiri dijaga hati crossing daerah berani shooting cetak goal yoojaehoon	neutral
marselino kebanyakan gocek banget kesempatan bola ketengah digocek	negative
inget kompetisi asia kompetisi kecamatan indonesia	neutral
yoo comeback	positive
klok ngukur lapangan	negative
kayak pinter	positive
asnawi gocek	negative
asnawi ambil bobol	negative
var offside pdahal menit	neutral
mainkan sandy wals lawan vietnam klok rkambuaya jngn masukan rusak permainan masuk	negative
peraturan skrg offsidenya diatas	neutral
adinda ngetik apasi ngerti sepak bola ngerti ganteng fc doang	negative
makassar sayangkn pas babk tarik keblakngpdahal keren skill sayuri	positive
asnawi ambil bokong tamengakhir kecoh lawan goal	negative
ayo semangatt garudaku	positive
pergantian pemaine ra masuk blas	negative
var	neutral
malaysia jordania klop nervous meren semangattt	positive
yakob dapet suplay bola malqh jenner asunawi bawak	neutral
marcelino wajan psti mateng gorengannya untung cetak goal	positive
lucu gmna performa bagus pujagiliran main lembek hujat lo gmna mending lo ajja main	positive
ofside wasit emang dirugiin	negative
sang juara terkalahkan sanggup bangkit pahitnya kekalahan keep strong indonesia	positive
goal penghujung bbk babak mentalnya bedabeda kalo pd timnas	neutral
taru bkn st murni pakai	neutral
ofsidee	negative
performance result indian national team failed team	negative
wasit liga cocok	positive
f haduh sdm etek etek	negative
struick struick struick blok	neutral
doanya kencengin biar menang	positive
rafael tengok kawan bujang egois wak	negative
kalah menang support	positive
rafael struick kunciin dikamar mandi	neutral
var asssssss	neutral
resky emng ruqyah dah orng ny kasian elkan jir serasa jaga deffend ilang	negative
gc lahh yo mas wani sanantha ae yo mas wkwkwk	positive
main main aneh	negative
comeback	positive
sogokan ruang var	negative
offside sahkan goal	neutral
bacot doang gede tolol bela negara lingkup rt berguna bela negara	negative
ketar ketir lihat	negative
sksksksk rafa mainnya underperform	neutral
ganti	neutral
good coach	positive
apresiasi pelatih pemain officialnamun mengkritik strategi styd konferensi laga ambil kemenangan seri kekalahantarget irak seri lantas strategi attackingbukan parkir busdan counter attack	neutral
terima kasih asian cup seeyou	positive
piwarang uih pal ti ayeuna	neutral
seru	negative
membawa boladi pressing panik alhasil bola rebut lawan	negative
rafael struick jancoook	neutral
mainnnnnkan sandyyy walshhhh woeee ampunnnnnnnnn	negative
emang pentingtpi mnjatuhkan mental pemainmau menang doangklah terima	positive
semangat garuda	positive
neng	negative
pergantian sty bikin kecewa yakob bagus sayap kanan bantu serangan diganti bek witan masukan jls serangannya lini ivar diganti justin bek masuk klok kambuaya leletnya ampun pegang bola dimas masuk ganti rafael sekelas liga kalo ridho cidera sandy wals dimasukin aneh bin ajaib	negative
sandy wals salah apaya sty cadangkan sandy dimasuk kriteria pelatih	neutral
makassar world class assist	positive
struick posisi aslinya winger kiri dipaksa sty striker bingung sty nih emang gabisa baca permainan tim gimana taru struick gabisa dipaksain lw tandemin sananta main kanan coba si yakob ivar klok parah walsh dimainin asyuhh	negative
nunggu sananta main sbnrnya mah	positive
apapun hasilnya semangat teruss	positive
wing back ny nyerang bagus bertahan kanan nutup jordi mulu kiri nutup elkan	positive
ayo indonesia papa kalah jadikan pelajaran semoga pertandingan hasil maksimal lihat nama lawan masuk lapangan kasih terbaik main	positive
udah gembira kebobolan tambahan bangat	positive
masuk piala asia hebatt smngg garuda	positive
asli asnawi passing amburadul	negative
sulit keseringan uji coba timor leste gini mainnya	negative
langsung offside gatau var	neutral
sdm rendah	negative
si asnawi beban tim piala asia next cadangan	neutral
f bacot	negative
beruntung bang second goal offside wasit	positive
bener netizen berharap indonesia membantai bantai tim grupnya timnas tetangga kemaren main berkualitas terbantai kemaren kekalahan semalam main iraq melawan goal kalah kekalahan mentalitas anak terbentuk kalah pelajaran pemain kemaren modal kedepannya	positive
bacot mulu nge golin	negative
nyiapin koper	negative
use var	negative
seri ajaa paak	negative
coret dendy dimas drajad pemain	neutral
merendahkan pemain sedikitpun asnawi sandy rafa sananta hokky kambuaya hubner switch position	neutral
washit tae	negative
ayo garudaaa	positive
kaya tai	positive
kacau	negative
coba pikir deh ngehujat emang merekaiyajangan egois main keinginannya menang kalahmereka berjuang bahagia masyarakat indonesia masyarakatnya ngehujatharusnya dukung merekadengan ngehina merusak pemikiran merekamikir	negative
iqbal bener menang dipujapuja kalah dihujat kasian pemain berusaha sekuat tenaga dihujat pendukung negara	negative
ayo gaes ramein ige afc protes goal irak	negative
var offside	negative
struick gokil bantu iraq golin	neutral
whatever always amazing	positive
makek sepatunya balet kak	positive
setia gabung timnas sreg rafael asli dah	positive
cari instagram wasit var ny	neutral
td ad sm kaki ny pas jatoh kali aja tuker sm klok hubner mundur cb	neutral
yakob fire posisi winger ditarik posisi fullback udah fullback bukanya diganti fullback winger segitunya sty sandy	neutral
woiiii ernando ketololan pinalti kemarin kalo sifatnya ganti kiper	negative
dah menit babak goal anj	neutral
hujat aje main mulut pd sampah	negative
tandain salah nerima tantangan dr	negative
gc betull	negative
babak comeback	negative
sah goal e gaess piye dungg	negative
proud guys keren terima kasih berjuang	positive
wasitnya berat sebelah	negative
p kalo info	neutral
kalo offside var	positive
klok kambuaya masuk lini langsung mati witan mainnya kureng sty telat rotasi	neutral
abang kritik asnawi nongol mulu	negative
yaelah mental akun fake	negative
rafael struick	neutral
asnawi pakengk banget grusak grusuk	negative
besok ganti pemain starting coach ernando cb jordibaggottridho lmfrmf walsh shayne gelandang hubnerivar striker marselino sananta yakob pliss lihat coment coach	neutral
alhamdulillah terimakasih garuda berjuang semaksimal smg next lawan vietnam menang	positive
heh mending nonton deh dripdaa ujung²nya ngehujat sama²dukung info ngeritik dasarrrr	negative
goal haram anjinggggg	negative
struijk ganti sananta biar hidup main	neutral
gereget pahibut didinya	negative
pemain egois untung pemain keturunan pemain lokal dh dipanggil rafael kesini serakah pemaingedeg lihat pemain	negative
ganti rafael	neutral
offside wasit var bilang	negative
asnawi beban timnas piala asia	neutral
bnr pengen banget ngeraukk mukanya	positive
sbar mas sbarr	positive
kasih keras	positive
komen ny kpn ngehujat	negative
cmonn bro passing maksa semangattt	positive
semangat trs indonesia	positive
offside andaikan serangan goal offside wasit lihat momen offside	neutral
f coba main	neutral
angel berharap	negative
asnawi ganti sandy wals	negative
mari silaturahmi wasit	neutral
jordi riskiridhokonci wc nantimhblunder ketagiantetap semngat timnas mash harapan	positive
ngapain cek var ajg	neutral
masukan nih tim mark klok efektif jatuh hilang bola guyssss	negative
penonton vision luas pemain lapangan vision terbatas hujatan mah abaikan masukan dikoreksi	neutral
rame rame komen instagram goal offside	neutral
kemarin var menguntungkan asia timur china hongkong korbannya terlepas ganti struick penyerang body speed	neutral
paksu nih	positive
kasian sandy walsh main menit	neutral
makasih coach makasih timnas indonesiawe love	positive
muk kaya taiii	negative
minimal seri	neutral
main uda lumayan match kualifikasi piala dunianext match win yok lawan nguyen	neutral
untukmu cobalah bermain simpel show	neutral
witan maeeen takti sty hancur babak udah hancur permainan starter sandy walshshayne pakai si atlet lempar melempar anjg emang bet	negative
go go go timnasayo semangat	positive
asnawi kaya captain dah heran bagusan sandy walsh kemana	negative
var sit kacau jlas offside	negative
pemain nyundul bola offside broo	neutral
witan lari aja	negative
rafael kureng	neutral
udah habis mnt peluit wasit bunyi	negative
heran walsh bangku cadangan pdhl pemain bagus	negative
var offside fifa	neutral
mnit terllau berpengaruh semangat garuda mengimbangi	positive
sulit banget sananta starter gaada bench	negative
rafael kutengok matchegois parahmaksa banget ad teman kosong	negative
poster match adaht ft adagmn admin	neutral
ayo comeback garuda	positive
cerah timnas termuda turnament keep head garuda	neutral
ir setuju	positive
dibayar wasit afc	neutral
pande baca permainan	neutral
gembosi var	neutral
goal irak offside var	negative
petugasnya orang thailand julid	negative
main pd ragu ngerebut bola nyaa	negative
punggung tajemmm	negative
setia opsi oper shoot udah shootnya jlek	neutral
sandy wals asnawi	positive
minimal engga wahabi kak	negative
bnr banget anjy ganti fakk banget	positive
resky ganti wahyu pras cocoknya	neutral
update score	neutral
telat masukin sandyyy gimana cerita pemain liga reguler liga belgia kalah saing pemain liga korea kalo anak emas kangol kalo tenang grasak grusuk ambil gabakalan shoting	negative
offside kocak pas percobaan blok smaa ernando	neutral
guoblok nggak peningkatannya memalukan bantaimending ngabisin anggaran doang	negative
sandy naturalisasi cmn utk cadanganbegitu dgn sananta ktya pemain titipan alasan pemain lbh bgs utk cadangan	neutral
mainkan si asnawi yong sandy simpan pelatih pengganti elu pertandingan smoga asnawi starter sandy sabar ntar pelatih andalan ngebet starter pindah liga korea karna liga korea setara liga primer inggris	neutral
fr bapakkau suruh main coba	negative
beli bek woyyy	positive
info instagram wasit lurr serang wasit bendera	neutral
bismillah menaang	positive
astagfirullah ampun deh netizen ngehujat terusss	negative
kritik permainannya karna egois goblok menghujat kalo egois blunder	negative
offside beuhhhh var jln n	negative
jordi jordi huft	negative
nice try guyss gapapa yokk fokus game	negative
kontrol bola	neutral
seandainya main babak	negative
offside pemain irak nyundul bola	neutral
sananta masuk admin bbk	neutral
goal mesti kembalijelasoffsed	negative
sayuri party	neutral
replay diruangan var kayanya beda cuplikan	neutral
arhan asnawi outt gampang lewati	neutral
pakai striker cok struick witan inbiar liar mainya ketebak bekknya	negative
greget liatnya bngtoh bnyak pemain bagus pajangan doangliat babak timnas lumayan agresifbabak kyak smangatnya	positive
bismillahsemoga pemain dlm sehat wal afiat utk bermain melawan vietnam utk meraih kemenangan semangat kompak sll	positive
ivar keren banget bjir	positive
offside	negative
kapten lagijijik	negative
iyaa bnerr letoy banget njirr	positive
cape proses proses jaman batu mending usahmain bola gubarin ajah cape lihat muak	negative
suruh hotman paris banding fifa	neutral
nyesel mainkan struick mainkan pemain berpengalaman	positive
terserah ajah kalah menang ge terserah capek	negative
emosi malam	negative
kalem bang aingge rudet sarua	positive
diserang fan girl struikk bng	positive
anthon lapornya kelurahan admin cuman jual hewan	negative
tisha	positive
gimana wir	neutral
blunder sty masukin witan ganti asnawikenapa sandy masuk asnawi yakob posisi	neutral
wasit online jelasin offside	negative
okee koreksi half timeniat pgn pegang bola build masi tenang degan duel kalah umpan silang pr banget crossing irak kali gagal antisipasigol karna bola puter area andri sapu bersih karna mendekati akhr bbk proses goal bagus masi individu yasa pemetrasi dalem trs passing enak marsel sekian	positive
bang jago	positive
selesai indonesia	positive
kanan kiri rapuh si	negative
pemain timnas baca komen berjuang tegakkan kepala mudah memikul harapan bangsa kadangkala harapan terwujud titik penuh perjuangan pemain jajaran pelatih eksternal fans sopan santun harapan pundak berjuang pendukung timnas sedih timnas kalah bahagia bahagia meraih kemenangan percayalah pendukung timnas waras semangat	positive
admin garcep updatea	neutral
gimana sepak bola maju kesel banget komen ngehujat pemain pindah negara gaada jiwa nasionalisme	negative
witan buyar permainan	positive
semangat garuda	positive
malaysia lolos grup qt vietnam buang total pemain lokal malaysia pemain asing tampil piala asia qt naturalisasi maluuuu	neutral
permainan baguss lestgooo babak ngeyel	positive
next halftime everything happened nothing imposible god says yes	positive
dukung vietnam dah	positive
nahhh proses goal ulah assist ivar jenner sayuri posisi sulit syuri lewatin pemain iraq gampang skill kelas dunia lihat marselino kosong tiang passing pemain tenang cerdas akselerasi bagus tinggal poles dikit main passing jarak intinya bola olah mudah ilang dapet bola berbahaya dapet peluang berbahaya perhatikan positioning bagus nyari celah kadang teman kolektif bek kanan asnawi kebanyakan dribble sebelas belas marselino witan egy arhan struick dendy sadil marc klok jordi	positive
info komentator bahasa inggris	neutral
moment	positive
semangat berjuang coach pemain timnas melawan vietnam beresin koper	neutral
segampang main haaa	positive
goal lawan kesalahan pemain indonesia	negative
goal kesalahan marselino asnawi sayuri kosong melompong kanan oper gocek mulu udah taru posisi himpit pemaen alhasil hukum counter attack pemaen ivar posisi blm karna nyangka oper	negative
rafael lemes banget trlalu bnyk delay bola sananta	negative
last minute bapuk	negative
greget anj panik hadehhh	negative
main grusa grusu asnawi	neutral
sandy wals jadiin starter pelatih	neutral
goal k sundulan offsidetapi pertandingan ngak berhentikan	neutral
setia bro sananta onfire liga	neutral
yudhiii sante santet wasitnya var dog	negative
tetep bangga hasilnya	positive
asnawi cadangin dlu hbis cedera butuh pemulihan mainkan sandy	neutral
wasit liga loro	neutral
dah	negative
tengahnya lincah kesadaran menyerangnya	positive
whay sandy	negative
nomor kunciin toilet admin	negative
bang bisanya komen mending diam deh	negative
mending ganti ilham oon	neutral
report besaran piala asia si blunder gini var botakk botak	negative
rafael poke ygy	neutral
kesel banget sma komen main jelek ganti ganti ganti tinggal nonton doain menangmereka berjuang mati matian jelekin paraaaahhh	negative
offside goal iraq	negative
indonesia sruh lawan mitra kukar	neutral
komplainnnn ayo	negative
asnawi np kepeleset coo	negative
geus deui ampun ah	negative
smngt timnas bismillah babak keduaa better selamat goal pertamanyaaa	positive
awkwkwk kocak emang aturan kalo komen pakai akun asli	negative
fr gunaaakalo gatau diem	negative
banget kalimatnya kaya kontribusi mas indonesia	positive
goblok emng banyakan gocek tai	negative
ganti asnawi sandy walsh	neutral
yakob sayuri msalah	neutral
gassss teruss menang	positive
tolong ganti asnawi rafael taik	neutral
ngegolin bang	positive
witan goblok	negative
sananta masuk raffael sty	neutral
nraini takutnya belain ayangnya mbaa	negative
bbrp kali laga uji coba kayak gt herannya dipasang starter	neutral
please dah next match mainkan sandy pattynama wingback arhan asnawi lengah mulu kalah bodi	neutral
yakopppp abroadd	positive
pemain club perpanjang club pasang tolong managernya ganti biar ngerusuhin pelatih ah	negative
benermainnya cakepberani pegang bolabola ngalir sinihidupkaya gini seneng bngt thankyou	positive
asnawi sandy	negative
alus pisan	positive
klok kambuaya ngapain masukkkkancor	negative
menanggung malu pertandingan	negative
asnawi ganti wals ivar jenner kelas	neutral
awkwkwk bener ngab	positive
semngatttttt	negative
heran sty fakta liga belgia kalah liga korea lucu lucu hah pantex	positive
ngedukung biar semangat main hujat	positive
diliat replay offside bang sundulan reborn offside taru dah bingung	negative
sty aneh penerapan pemain rafael perform diganti sananta masuk asnawi maksimal diganti walsh diganti witan korelasinya coba	negative
admin satset half time lngsung post full time langsung post nyetak goal langsung post profesional banget	neutral
fokus bismillah yok	positive
oalah rizky ridho intersep bola udara membelakangi lawan	neutral
bilang taeyong admin sturik ganti	neutral
emang mainnya hancur ancurran mo diharapkan	negative
better ezra finishing bagus	positive
styout	positive
goal iran offside dluan pas sundulan ditepis ernando	neutral
timnas babak	neutral
update skor mw komen	neutral
asnawi captain fungsinya	negative
ewako sayuri	positive
maklum bang nama anak anak lulus sma	positive
need fair coach put fav players field best ones sandy shayne sananta shouldve starting	positive
rizkiard rafel klanting	neutral
banget bawa bolaa	negative
rafael ganti witan ganti walsh orang kacau maennya	negative
lini coba dirombak coach blunder	neutral
big thx coach	positive
var shit	neutral
mark klok witan ngapain si anying	negative
apupun hasilnya patut apresiasi good game iraq nice try indonesia	positive
kurung kamar mandi witan kambuaya klok asli bapuk	neutral
kebayang lawan jepang gmna please main simple gucak gocek dpt bola pasing tai tai	negative
lini wassalamualaikum warahmatullahi wabarrakatu	neutral
ora taru menang	positive
kebobolan kesalahannya bek	negative
struick	positive
mmy langsung instagram wasit	neutral
f situ main bang cuman bacot doang giliran menanng ngikut ngasih congrats	negative
aminn moga imbang	positive
var bulshit	positive
hubner ganti bener kawan	negative
marclok witan duo gjls	neutral
semagat	positive
please next game sandy wals wajib starter	neutral
malaysa kena bantai jordan terobati luka	negative
gayss silaturahmi instagram wasit	neutral
makassar assist mantapp	positive
rafael setrukk lobaaa gayaa	positive
offside sii tdi pdhl kena kaki pemain jatuh gtu jatuhnya umpan mnjdi ffside	neutral
var lagii duhh	negative
sty ganti giovanni van bronckhorst	neutral
terima kasih penggawa tatap laga lawan vietnam semoga hasil terbaik	positive
anjirrr si ngehujat pemain ngejatuhin mental orang	negative
л	negative
gregeta	negative
heran menang orang iraw backingannya langsung syekh turun tribun	positive
disitu sty membangun timnas kedepan mental asah regenerasi bangun sty emas asah proses lihat sekrg emg menyakitkan bayangin main piala asia tingkat kepercayaan tim	neutral
sekelas pemain utama liga belgia milih pemain cadangan liga korea selatan yong yong	neutral
terimakasih berjuang garuda apapun hasilnya terimakasih blunder berusaha semaksimal	positive
geritan buhannya maennn	negative
oi offside lawakk	neutral
wasit galiat var ajg	negative
tenang panik kekonyolan pertahanan lawan irak boss anak smp	negative
elu main parah	negative
hadeuh marselino memaksa	neutral
kalo timnas mendunia perbaiki pemain coach ketua pssi	neutral
jauhar komen mending gausa komen tod gajelas	negative
nge hujat ges malaysia parah pdhal sm jordan levelnya lbh rendah dr irak	negative
sok pandeakun fake aja la	negative
thank indonesia keep strong	positive
already say	positive
menit full lihat kucing erick	neutral
hehe asnawi	positive
butuh kiper naturalisasi admin	neutral
nontonnya pakai hati kali emosi mulu bawaan	negative
irak press indonesia dominan bertahan diterobos	neutral
f bayar pajak	neutral
kambuaya rikky masukkan ganti ivar	neutral
tolong man teman sandy walsh diturunkan jelek asnawi sesuai skema	negative
rcti dajjal nonton timnas iklan iklan gede banget	negative
coba masukin wahyu pertahanan kokoh engga coba taru bagus hulk drpada riski ridho	positive
kesalahan terbesar timnas starter asnawi struick pdhl shayne sananta	negative
alzio cek bang	positive
wasitnya lawak asli	negative
setia struick mainny letoy	positive
udahlah akuin ajaemang timnas stuck gtu ajajgn berekspektasi optimis bolehtapi realistis	negative
offside bang penjelasanya bang	positive
var wasit bgst	neutral
dejavu	neutral
sandy walsh setidak menit bermain witan balikin sayuri	neutral
marss bilang orng realistis banget suka fakta jdi kesempatan orng bdh taruhan timnas pegang musuhnya karna udah untungcuan udah realistis	positive
ofside ah report dah akun wasitnya	negative
struick kebanyakan gocek payah	negative
blm infoinfo admin	neutral
keren semangat timnas indonesia	positive
sayuri good game	positive
skip anak mamih main	negative
murni darimana masitu jelas² nyundul dah pemain indonesia	negative
gajelas dmnakasih taru dmna gajelasnya	negative
witan klok main blunder gblk	negative
main bertahan timnas bagus bertahan berani pressing one touch shooting jarak dll lihat celah lawan bermain bertahan timnas bermain area yoojaehoon	neutral
f apasih kontolapa	negative
saran admin marc klok kambuaya dimas drajad list pemain diharamkan main admin	neutral
timnas ancurr byk oknum politik	neutral
var var	neutral
egois kaya pengin banget unjuk gigi peduli kemenangan tim	negative
babak yok nambah goal indonesia	negative
struick cocok targetman	positive
miris lihat komentar	negative
gs fans rafa jujur malam kecewa bngt rafa greget	negative
sty striker mu strategi striker main brtahan gempur karna hnya menunggu berharap serangan kesalahan umpan gagal marking berakibat goal lawan pemain timnas mnit sdh klihatan ngos ngosananda tdk ganti pemain fresh telat ganti pemain rragu dg kualitas pemaim bench sdh pilihan terbaik mu coachh sty terhormat	positive
dimainin nadeo ernando gmn si pelatihnya gaje bet tololpadahal kalo nadeo main kayak king barca	negative
asnawi ganti masukin putu gede	neutral
sandy dr asnawi	neutral
supporter norak	negative
indon asu	negative
iyakk	positive
iraq main body kasar butuh energi bang masukin riski rido lewalahan body	negative
wasite buram jengkel	negative
indonesia semangat	positive
plis kali struick istirahat ganti sananta	neutral
cheking var cepet bjir	negative
vision kayanya	positive
mndng sananta kmn² anyink²	positive
semangat garuda	positive
mending fokus daki gunung si guys	negative
kalo kasih goal tandanya main full time cape gtu	negative
var qatar eror pemain irak kena offside kasian timnas dirugikn dgn keputusan wasit	neutral
ganti sananta	neutral
yogaa sananta dendy shnye dibawa ngelawan irak	neutral
overall mah udah bagus sayuri cuman greget ajaaa lihat struick oke bang	positive
marselino netizen bacot	negative
ciwi² pendewa struick sleketp auhay gubrak butuh pembelaan niii	negative
bek sayap inti belgiatapi mainkan bek grasak grusuk free agentgak ngerti si pelatih korea ituanak emas nyata	negative
maklum bang netizen gapunya otak	negative
offside	negative
mending hapus ja komen malu sndri	negative
ayo layangkan banding merugikan timnas indonesiamafia bola hakim garis disogok	neutral
goal offside hakim garis bagimana	neutral
jy nambahin jordy msh blunder tolong ditenangin	negative
kurangin blundernya	positive
jordi jordii	neutral
lari lari cengengesan tan	negative
kesalahan fatal posisi hubner titik	negative
comen biar ahlinya jelasin	neutral
instagram wasit	negative
doakan terbaik timnas	positive
susah bro anak emas wkwkwkw	negative
semangat berproses garuda	positive
rafael cokkk	negative
prediksi lineup versi formasi ernando cb baggot hubner ridho ivar jenner marselinoklok lm shayne pattynamapratama arhan rm sandy walshasnawi rw yakob lw witan st ramadhan sanantadimas drajadhokky carakarafael struick	neutral
suerrr	negative
taru laki ketikan julid beban negara sgt minim akhlak kerjanya hateee smpe capek lihat komentar malu banget kyk orang sklh gt	negative
wkwkw serang penyepong orang fakta menit main egois berbuah goal kritik permainnanya karna egois serang anying	negative
klok gatel mainmu cok perusak ritme	negative
struick	positive
suruh ngukur jalan wasit	negative
struick mnding sananta	neutral
gunanya var yak ngeselin banget	negative
wasit sekelas piala asia pemain irak ketoel dikit jatoh pelanggaran goal le offside replay	negative
makassar kalo menang motm	neutral
golnya dianulir belom rezeki gaes bismillah babak nambah goal indonesia amin	positive
sty fiks sdh hrs ganti si taktik aneh jalan pemain naturalisasi eropa terjemahkan taktik ganti dr eropa bagus	negative
witas jelek banget mainnya	negative
witan struick bangsat	positive
satukan doa kt kabuat timnas sdg brjuang	positive
ilgiz tantasev uzbekistan	neutral
anak emas stywkwk	negative
semoga babak comeback	positive
komen suhu	neutral
masi kebobolan jink	negative
orang gunanya heran sty sekelas lilipaly call	negative
siy delete chat malu dah julid	negative
semangattt	positive
striker modal ganteng asyuu finishing adangontrol bola gj	neutral
serbu akun bro	negative
jos sangar kabeh semangat yohhhhhhh gas neh babak	negative
greget jing	negative
witan rafael kambuaya si maestro klok pekok banget main pemain ampas	positive
senam jantung	neutral
yaudalah tidur laah	negative
kapok menit aja yong ganti pemainnya	negative
ivar diganti langsung mode liga bri	neutral
ngomul bang	negative
e andalan sang penyepong	neutral
keep fighting	positive
salah target tercapai tinggal insyaa allah menang lawan vietnam imbang lawan jepang	neutral
offside	negative
suruh plg aja timnas	negative
tetep dukunggg gimanapun hasilnya tetep garudaaa	positive
semangat garudaaa balas babak	positive
asnawi anak emas	negative
gemes	positive
fungsi var sattt gregett	neutral
asnawi ganti sandy etdah	negative
keputusan wasit kaya keputusan mk bgke	negative
asnawi marklok	positive
makassar ewakoo	negative
imbang bagus banget	positive
kena rambut bang	positive
rizky ridho lembek banget dibelakang	negative
coba riyandi kiper kiper indonesia savenya	neutral
offside tolong please bantu protes	neutral
pemain salahpelatih tolol	negative
nice try	negative
klok pantesnya main congklak dah	negative
makassar good game pemainmu broo enakeun tinggal yance main udah deh enak nih	positive
aman kta si wasit	negative
offside goal njir	negative
bingung sty pilih pemain sturik pemain belom matang blom main timnas asnawi masuk starting tolong evaluasi jordi dandy next kualifikasi coret	negative
fokus dukung evaluasi serahin tim inget tim peringkat terendah tim termuda realistis	neutral
offside kayak var	negative
sandy walsh apalah kuch	neutral
main jht bsa nyogok wasit gt biar ad pembelaan sm indonesia	negative
gemess banget gasihhh	negative
coba jelasin offside pdhl pemain iran sundulanya kena	neutral
jualan seblak ajah	negative
contoh vietnam mainyalari jalan kaki	positive
sabar bang asik bang asik	positive
karyawan	negative
gimna lo aja main ngebacod doang	negative
sia siain peluang doang	negative
asnawi kasih minum jus biar tenang grusak grusuk	neutral
witan ngapainn kalo cumn joging ganti atlet lari kreatif nyaa	negative
iqbal	positive
optimis	positive
mainkan sandy	negative
kritik sty pemain berjuang pemain bagus lapangam gimana pelatih kasih game plan	positive
semangattttt	positive
mending dipecat si sty menganak emas si asnawi keras kepala banget timnas dijadikan taruhan anak kesayangannya	negative
msh mertahanin asnawi kebangetan dah sty	negative
asnawi arhan marcelino beban	neutral
sabar bangg	positive
ramadhan sananta masukin dongbiar gaya gedor	neutral
asnawi rafael ganti	negative
sananta masukin cooodia aus goal	neutral
shandy aulia masuk	negative
makassar yasa emang kerennn eyy	positive
bacott bet tai dilawan irak persib kocak gampang blok	neutral
nonton rcti koq mbak	negative
coach mainkan sandy coachh aghhh	neutral
nyundul bang	negative
pertandingan kali alasan indonesia sulit mencetak goal pemainnya kesenjangan skill pemain tipikal main benua eropa cenderung dominan banding pemain pemain bermain liga lokal buntunya lini serang mengandalkan lino sisi kesenjangan dimana ridho kalah duel lawan pemain irak goal ketiga irak membuktikan ridho kalah telak sisi duel vs sisi struik ivar mobility kesana kemari target tujuini wild card dibenahi sty coach krna wild card golden card pemecah kebuntuan renggangnya permainan indonesia malam terbukti kekurangan striker bner bner spartan haus goal anyway permainan malam buruk buruk banget bagus lagipermainan imbangi goal lengkap semoga ragnar thom haye bergabung krna bsa opsi terbaik utk menambah daya gedor timnas indonesia masuknya pemain venezia bola bola udara udah khawatir pemain irak kali penguasaan individual bolanya bagus bagus ntah ngerasa tenang timbang pemain indonesia kelemahan indonesia kurangnya tendangan spekulasi utk eksperimen intinya semangat indonesia kesempatan vietnam meraih kemenangan apapun dah ckup bikin vietnam terbenam indonesia lolos	positive
lini nyaa tetep pelanga pelong	negative
tanda tanda nich	negative
udah harapan seoptimis gimanapun emng udah harapan kalo lawan vietnam dapet poin tetep bejekkk jepang	negative
ngehujat langsung main dilapangan	negative
bingung arhan asnawi dimainin engga menjalankan tugas bek sayap shayne sandy dimainin teruji bermain dieropa permainan bagus passing tenang	positive
ayo bantu doa timnas	positive
ghozali sok asyik	negative
semangat garuda	positive
caper	negative
rafael kakean ngck gantiii sananta	neutral
next sandy walsh mainkan asnawi hadewwwww	negative
info akun wasit bro	neutral
gas truss garuda	positive
jancok loro cokkkkk	negative
yakob bagus eh gantiin asnawi masuk witan sandy walsh gantiin asnawi	negative
comeback lahhhhhh	positive
good job garuda boys	positive
struick ayooo tunjukan kekompakan tim inijangan egois	positive
ivar justin hubner yakop	neutral
gunanya var ko event piala asia	neutral
gerakan goal offside striker kalo peluit stop game	neutral
pd numpang bacot doang gasuka nonton tolol	negative
opset co aturan	neutral
mah bicara realitaa lapangan ngabb	neutral
wasit butaa var gunaa offside gimana sihhh	negative
nihyu yuu	positive
pemain main bagus support ngimbangi berbuah goal	positive
saran admin taru rafael kalo ganti sananta rafael main ngotot ngambil keputusan	negative
wasit nyaa ajg irak dr	negative
f komen bang apresiasi kali timnas	positive
ikuzzooo wasit geess	negative
akui blunder masukkan witan asnawi besok cadangan bagusan sandy walsh	neutral
bek bikin degdegan fungsi witan masuk kebanyakan makan indome goreng	negative
jujur lihat pemain main perjuaganya cmn tingkatin startegi dgn pemain melengkapi	positive
apapun hasilnya banggapemain muda butuh jam terbang percaya proses	positive
struick	positive
suport indonesia menang kalah indonesia	negative
offside	negative
top comment	positive
emang bener anjayy	positive
alhamdulillah	positive
asnawi pulih rafael struik tolong dimainin biar dimas drajad babak kalini ucapkan good game timnas indonesia pengalaman kalah mental ayo ayo indonesia garuda dilangit dunia	neutral
setia aslinya winger finishing sii positioningnya bagus buka ruang	positive
inpo ngopi seng kirane tim mu ben kompak pye indonesia	positive
hehe	positive
offside goal	negative
kasii tauuu	positive
ngganjel goal	negative
timnas nonton kecewagak nonton penasaran	negative
yakob	positive
support timnas pemain berusaha timnas berproses broo semangat pemain pelatih	neutral
ayo akun afc iraq offside	neutral
asnawi ktemu klub mainnya kyk singa lawan klub jdi kucing	neutral
firaun klamaan thun usia jonpling thun asia	neutral
gnti sananta	neutral
good game boys	positive
rafa ego	negative
netizen netizen nonton bola menang indonesia nyerang serang kebobolan kesalahan namanya lapangan taru situasinya gimanaaaaaaaaa	negative
menang nunggu banget hehe mimpi nyata	positive
true pass ridho obat	neutral
mari beropini pertahanan kanan sandy wals penyerang kanan yasa sandy wals main santai rapi yasa bagus bertahan menyerang	positive
nu bener	positive
diakui sty meng evaluasi pemain memandu pertandingan pemain menatap laga akbar bnyak perbaiki pcinta timnas offensif kyaknya udah move coach sty hasil maksimal slesaikn afc pssi cri pelatih smahal bliau memiliki cttan kplatihan bgus prcuma paksa sty mentok dn memajukn timnas	positive
var lawak bang	neutral
offside	negative
klok banget anjirr mainnya asli gajelas	negative
pusing gini mainnya	negative
e andalan penyepong dikritik disuruh pemain bener overrated lepaaass	negative
pemain liga utama belgia cadangan lawak	neutral
ketemu wasit kaya	negative
admin ganti	neutral
fungsi var anyingg	neutral
info tukang print qatar	neutral
wake lur sodara sodara dilapangan katar butuh dukungan fans timnas indonesia tercinta tolong kasih pemain timnas mudah bersaing level permainan cepat pressing mendukung berargumen butuh bantuan moral mengarungi sisa pertandingan grup kesempatan lolos komen negatif buang	positive
offside	negative
rafael egoisnya ampun	negative
marcel marceng ngaceng	negative
mata melek pemain naturalisasi candangan coba back pasang sandy hubner baggot ngapain rizki ridho jordi raja blundermasuk witan kayak orang kebingunganmarklok ivan janner tarik keliatan permainan engga jalan seru cuman backnya ceroboh kualitas team keliatan main liga pemain liga indonesia nonjol cuman yakob sayuri aturan sadil kiri lino sandy walsh keliatan walupun masukin menit baca bolanya oke strategi sebagus apapun kalo pemain underperformace tetep susah ngembangin permainanmasih dibawa sty perpanjang kalo orang indonesianya managerny sumarji mending sty kasihan kualitasnya mending full korea manager kalo berkembangbiar pemilihan pemain engga buta butuhin bawa keliatan kualitas pemaincontoh yakub main liga oke timnas keliatan mainnya coba bawa dandy egi witan td mainnya kayak anak bawang acungin jempol lini perlini ketat masuknya mark klok kayak main liga tarkamkena kartu kuningmasa mark klok habis bawa	negative
ramadhansn ohh dimainkanmalah milih dimas klok kocak	positive
sabar bang ngamuk²	negative
tbh shin tae yong blunder memasang mengganti pemain kalo nawi perform salahnya walsh main pemain eropa kualitasnya jelek susahnya coba elkan ridho cedera ganti ganti diakui sty sebagus ekspektasi nice try sty see top	negative
pertandingan semoga pemain fit	neutral
bagaskara var	neutral
pemain pelatihnya bermasalah	negative
pemaen protes ikhlas bener posisi penyerang lawan offside wasit review pakai var	negative
nzl lihat umpan ridho taru dijaga orang dikasih susah kalah si jordi press orang	negative
mending wasit iwan sukocoo	neutral
opset opsetan	negative
lihat penampilan asnawi titik lemah sblh kanan lewati pemain irak goal kecoh fanatik buta mas salah koreksi	negative
yaki lolos pringkat terbaik	neutral
semangatt indonesia	positive
asnawi sandy walsh	negative
sek sek koe kontribusine nek negoro yok opo untunge koe nek negoro iki opo yo nan ngakak ndelok kon ngomong ngene ora ngoco blass	positive
rafael stuck striker si bingung	negative
mines banget malem	negative
tetep semangat garuda	positive
hubner taruh bek jordi ganti klok asnawi gnti sandy walsh rapael sturck gnti masuk dimas drajad sananta	neutral
njirrrr	negative
hahahah asnawi main jga kejebolan wkwkwk	negative
fr ngatur² hidup bisanya emang pelatih penguasa coach hah gajelas	negative
target seri dah ok	positive
mikir bang heran	negative
next sandy paatynama main utk lwan vietnam	neutral
hargai pemain bang berusaha keras main piala asia lawan diatas rangking gaya permainan koordinasi tim	neutral
goal offside var tetep sah	neutral
aadin coba buka matanya mas	neutral
gas sparing tim	neutral
terbaik timnas bangga	positive
var	neutral
f keren lo	positive
witan sihpadahal masukin sandy ganti asnawibiarin yakob depaneh masukin witanya kalah fisik astaga	negative
sono daki bang	positive
cwpek	negative
makai orang orangan sawah gawang bole si	neutral
putra lihat komen nyalahin rafael jordi blunder mulu disalahin	negative
sayuri udah bagus nggiring bola suruh bek gimana sty oh sty	positive
main kontloo	positive
wasit paham aturan offside bang kalo emang anj si keputusannya	negative
gacor	positive
semangat timnas	positive
nyenyenyenye	positive
ayo indonesia bangkit babak indonesia champion	neutral
fix babak ganti rafael stuick	neutral
info admin komentator alumni pesantren	neutral
aprsiasi pemain udah berjuangemang hasil bagus pemain terbaik malam	positive
info instagram wasitnya	neutral
stricker starter mulu heran ganti	negative
kalah ttpan var gaguna	negative
kebelet cetak goal	negative
tegak kaan kepala garuda pertandingan cuman	negative
aasnawi story instagram	positive
cari akun wasitnya kontroversi goal ketua irak	neutral
jordi amitttt	negative
apapun hasilnya yaudah mo gmna	positive
fr komennya koq gini bang	negative
rafael kebanyakan sosmednya bangun fisik	negative
goal offside	negative
asnawi ganti habis cedera sandy bagus banget nggak starting	neutral
bek blunder	negative
naturalisasi kalah	negative
ayooooo babak kasih goal lagii	positive
malaysia untung indonesia	positive
yes hrs ny offside si cmn syang indonesia beruntung goal ny sah	neutral
rafael stroke maine gajelas blass	negative
arhan gajelas ngilang	negative
jelasin wasit online golnya dah semenit detik ofside ko sah	negative
pelatih online	negative
lini dapet bola langsung buang semangat laga garuda	negative
bro goal indonesia pemain lokal marceng yassa goal irak karna kesalahan naturalisasi struick	neutral
kena bang	positive
ayolah timnas sandy walsh starter pratama arhan coba istirahatin kasih kesempatan pemain next matchnya	neutral
fiks starter asnawi hilang bola	neutral
goal irak offside	negative
masukin sandy wals dr coach	neutral
struick gantine yong gusti	neutral
f ireng minim prestasi bacot	negative
ernando kegendong bek cuman shot target save x one kalah kelas ernando mending ganti kiper	negative
bunuh wasitnya cok	negative
bp info akun wasit	neutral
aaaakkk kasiaaannn aaaaakkkk	positive
ayo	negative
sin blokkk	negative
sananta shandy dimaksimalkan	positive
goal offside	negative
berharap kali starting kedepannya nadeobaggotwalshpattynamahubnerjenneredoyakobadam alissanantawitan	positive
salut banget timnas kitaa bravo	positive
negara demokrasi bebas	neutral
kecewa kalah wajar fokus dukung indonesia lawan vietnam	negative
offside jir liga sistem varny	neutral
bangga bangettttt hasil ukuran jga sii optimis lakuin terbaik ngeliat latihannya emng kemampuan ketinggal sadar good game bangga banget perjuangannya makasi udah bawa bendera berkibar piala asia lolos kualifikasinya gampang tetep keras match lakuin terbaik perbaiki evaluasi kesalahan istirahat hebattt kerennn makasiiiii garuda	positive
bagus anak mudaperjalanannya panjangbaru ngikut piala asia stlh absenkerja bagus semangat	positive
respect sodara pemain timnas gimana pemain timnas berbenah mengimbangi permainan negara manapun keep strong brother	neutral
sadis umak	negative
offsidee lahh anjjjj	neutral
striker modal ganteng ganti woyyy	neutral
si witan orang bego plenga plengo	neutral
opsed oii kaluu	positive
offside goal	negative
sandy main pliiiiisss asnawi level	positive
egois	negative
ayo indonesia bangga masyarakat indonesia pertajam finishing berani mengambil keputusan semangat	positive
aowkaowkwk	negative
emang sananta masuk susunan pemain opsi dimas drajad bilang hoky dg rafael	neutral
klok kambuaya masuk hancur mainnya	negative
coba cf lilipaly mungkil unggul	neutral
keep fighting garuda bismillahirrahmanirrahim semoga allah swt kemenangan amin	positive
apdet golin gimana admin adminnya	negative
admin malas update hemmmt	negative
sandy kalah anak emas	neutral
witan	positive
rafael struick ajarin main team	neutral
tutup kegantengan nnya pdhl mainnya	negative
allah indonesia main keren banget emang iraqnya neken	positive
jatuh nyundul ngarahin gawang offside kocak	negative
var kalah bandung premier league	neutral
respect tim tampil piala asia hebattidakada instan proses	positive
kelas asiaaa woyyy bangun loyo ajang dilirik dunia main gagah takut salah	negative
nonton hp gimana	negative
wasitnya belom make insto bang lihat offside	negative
pratama beneran gameee doangg gameee suka bawa bawa bola jelasss muter jelasss penghilang tempo permain banget	positive
terima kasih best see next match god bless	positive
offside	negative
komentaar	positive
soleh arhan oke bro asnawi tai	neutral
cheking var offside pas	neutral
sananta nh gereget sananta	positive
ayo rafael struick greget yok	positive
sty	positive
inpo	negative
bau bau ordal irak kuat	negative
rafael struick	neutral
greget gesss	positive
paringi indonesia goal luwih kathah tinimbang iraq allah	positive
kalah kecewabagus mainnyacuma mnt² babak k agk kendor sdikit bagus mainnyasakit perut plus tegang nontonnya	negative
abdyn bang	positive
ngoper klamaan bawa bola krebut trs asnawi mainya buangbola	neutral
patinama sandy wals lawan vietnam	neutral
taek babak ok busuknya babak busuk bukanya ditendang sayap anak emas dimasukin klok kambuaya witan afc aff	negative
mabok kecubung main lol	negative
asnawi jatoh mulu perasaan	negative
bener keren dah pokoknya	positive
goal sah anjjiir sayang bgtt	positive
beda level tunggu pembalasan auto bantai indonesia jaya	neutral
sananta mainkan dimas wkwkwkw kocak bet dah	positive
kurng paham si kalo offside dianggap onside	negative
offside hrs	negative
inpoo	negative
kanan kiri babi	negative
sandy walsh dimainin²	negative
nda malu bangsatt	negative
struick egois bener maksa buang momentum penyebab kegolan wingback asnawi arhan diandelin hancur parah trio cb hubner ancuran	negative
mending langsung serang ajagasiii instagram	neutral
salah asisten wasit	negative
kalo hujat sty reply komen sty kerja keras hujat lo suruh kalo mao bayar deh lo setara sty kasih jaminan kalo friendly match lawan argentina menang deh	negative
sebagus apapun pelatihnya pemain dasar sepakbola pasing kontrol ditingkatkan mental tim pemain muda esok kelak tim hebat semangat boys	positive
ofseddd woiiiiii	negative
otw akun afc cup	neutral
cek coba offside atw onside	neutral
instagram wasit	negative
nanya ofsidekata komentator ofside bejirb	negative
iqbal pemain selamat hasil lumayan taktik tololnya styuntuk sty korea dagang kimchi	neutral
yukk	positive
biasain nonton habis komen bang nonton chat sosmed	positive
horok iki tek nengdi²	negative
bawain bang indonesia biar jernih wasit	positive
kalo saran nih cobain kambuaya starting duluan gantiin hubner passing kedepannya visi kaya jenner depannya kenceng paketan marcelino yakob rafael arhan asnawi main bek sandy elkan shayne	neutral
rizki ridho gantiiii	neutral
jordi ngapain kena mental kali goal gara	negative
bek panik udah taru lawan irak emng lawan brunei gocek gocek	negative
ris sabar menit pluit kegolannnn	positive
permainan bagusss cuantikkk menikmati babak semangatt terussss ndannnn	positive
bagus berani pegang bola namanya main bola melulu berhasil gocek bro marcelino sayuri berani pegang bola wlaupun patut apresiasi ketimbang kaku berani gocek ujung buntu bolanya kemana namanya main bola berani pegang bola apapaun konsekuensinya jidan jidan	positive
sty pelatih eropa	neutral
rafael asik asik	positive
witan ngapain	negative
sananta bro ujung tombak sty milih dimas hokky wkwkwkwkw	neutral
mending main sosmed timnas level asia	neutral
iraq crush indonesian team	neutral
aslii	positive
goal asnawi panikan taru nutup ruang umpan tendangan gaya kepleset	neutral
offside terusin	negative
ayo semangat garudaku pertandingan melawan vietnam wajib poin	neutral
taun hareup edankeun ah keun ayna mah ngalalanyah heula	negative
cari kesalahan pemain bagus puji wihbagus berilah semangat timnas	positive
kencengin doanya hujatannya berjuang disana	negative
h mbak jan brisik mba	neutral
setuju var mari boikot si botak	negative
asnawi	negative
eh gil hidup kepleset	negative
struick ganti gocak gocek doang	negative
rafael beb	neutral
kaya jembut	positive
gila sekelas sandy walsh kalah saing asnawi witan	neutral
struick kalo ngetik bang	negative
wasit matanya katarak disogok irak sihudh var offside	negative
lumbung goal	positive
gimana ko indonesia iraq timnas iraq easy cuk	positive
yakob membuktikan pilihan utama sty	positive
proud garuda	neutral
update admin galer yak	neutral
goal sah aslinya obsede duluan	negative
penyepong struick kwkwkwkw	negative
offside	negative
babak perrama bagus siaran pke nyempitin layar pke iklan greget komentator bhs inggrsvberasa vibenya piala asia	positive
witan ganti shen tai young	neutral
offside pemain rebahan gawang orang nyundul wasitnya orang rebahan dianggap	negative
naturalisasi ujungnya kalah	negative
offside gerakan bang	negative
kpn atuh menang	positive
dasar netizen bisanyaa ngeritik ajaa dukung ngehujatt liattt orang lo hujat ngegolin ngimbangin skor	negative
ah elah witan masuk yacob cocok winger	positive
makassar pemain psm keren kayak pulau sebelah titipan	positive
lambattt main operan cukjangan caperpada ngebet viral	negative
ndapatady babi	positive
goal irak onside offside	negative
live youtube nama chanelnya tv sinyal ilang rcti eror	neutral
angkat tangan komplain	negative
lihat live online ndak	negative
kmu nyuruh²	negative
liga spanyol offsidepas ferran torres nyentuh bola	neutral
menang kusanjung kalah kudukung	negative
untung ofide	positive
shen tai yong irak ganti ganti pemain indonesia analisis pemain lelah performa buruk	negative
buset kena gimane bola berubah arah mkanya kena kaki ernando	negative
diganti pas menit palingan	neutral
motm klok kambuaya dimas drajad	negative
witan ngapainnnnnn	negative
aadin lo pas goal	positive
sandy masuk beda mainnya esteyek lihat	neutral
datangi wasitnya bang komplain	negative
kritik bang berusaha ngapain tinggal nonton doang	negative
masbro muak tolol pemain performnya dimainkan asnawi klop coba ganti	negative
tolong banget pegang bola	neutral
guys great dont listen people say done best thank	positive
arin orang sedari bocah cungkring nomor setuju pemain sekelas liga tarkam terbalut liga elit orang menghujat dendi dengannya tipikal permainan	negative
varnya kw om	negative
kasih semangat jngn hujat	positive
goal offside	negative
f cangkemann	negative
selagi jokowi presiden kalah	negative
nzl nyundul gawang cik	neutral
nge hujat bang hujat nurun kepercayaan mending kasih semangat	negative
kapten passingnya amburadul	negative
beknya muter mulu tinggal buang	negative
tolong walsh main ganti asnawi	neutral
pertandinvan tunggu	neutral
offside ketua goal iraq	neutral
struick tolol rudet sananta kamanaaaaaaa coach	positive
ganti	neutral
sandy main	positive
uploadnya gercep dah	negative
yoh minimal seri biar aman	neutral
guyss ayo dukung timnas lolos fase grup hujat berjuang	positive
next match asnawi arhan wajib diganti	neutral
butuh pemain tipe sadil	negative
pemain lemah	negative
semangat qt dukung indonesia butuh dukungan cacian	positive
firaun penguasaan bola pemain main indonesia pasding control bola bawa bola lbh tdk mempertahankan bola tujuan dioper lgsg shoot bola hilang kerebut lawan penguasaan bola individu	neutral
goal irak gara² rafael langsung buang bawa bagus	negative
tolong ajukan banding goal iraq kalah butuh keadilan msinulingga tisha	neutral
sbaarr bangg	positive
rafael stuck main cacat kaya bocah lapangan bola gede cuman lari doang	negative
cok kasian defender pemain bapuk	negative
coach striker ny coach	positive
rafael struick bagusan dendydowski pemain gizi si rafael	neutral
rafael cape ganti	negative
haji nawi menit ka tekuk sadesa euy ah	positive
tolong mainkan sandy coach	neutral
nice try bobo	positive
asnawi arhan tarkam	positive
berisik nyet makannya nonton	neutral
updet banget adminya	positive
gaguna galayak	negative
wasitnya burem kali yak	negative
taru	positive
makassar	positive
pemain inti liga belgia kalah saing pemain persija liga wkwkw coba sandy tayo	neutral
marcelino tolong dimainkan asnawi arhan	neutral
ndapatady caper	neutral
sty pondasi timnas indonesia ganti patut apresiasi kerja sty timnas pembibit pemain muda progres lanjutkan pelatih filosofi bermain matang	positive
kalo bisaa rafael struick ganti sananta	neutral
itukan offside yagasi	neutral
instagram wasitnya dah offside goal	negative
jordi blunder tdi	neutral
offside cok wasit konoha taru kalo offside	neutral
offside goal	negative
pliss kunciin asnawi	neutral
sandy walsh mainkan jancog	neutral
asnawi ridho ganti klok sandy walsh hubner dijadiin center back	neutral
liga bri masuk matiin tv	neutral
witan	positive
nagami parah nii thailand	negative
bek bikin panik	negative
struick blokkkk	negative
bule kontool si klokcocok main liga dangdut kao	positive
wara barusan nyoba gabisa	neutral
bang offside	negative
yakobbb sayuriii hebatttt	positive
lawan iraq kalah lawan vietnam kalah lawan jepang kalah bocah tiktok main piala asia	neutral
baraleg bebel main teh	neutral
buang club	negative
goal offside	negative
hhahahahahahah ht	negative
udah keliatan starting main asnawi arhan udah hasilnya	neutral
berkomentar negatif dukung timnas	negative
permainan passing salah kontrol bola salah dribbling salah kelas asia guys lawan brunei	neutral
asnawi	negative
var jir mata wasitnya buta kali	negative
striker gocek	negative
nice try indonesia	negative
pengennya indonesia menang pemain bikin kesalahan hate comment semangat gmn menang	positive
hadehhhhhh	negative
coba gucak gocek teu pararuguh	negative
dicatat cuman nilai si struick orang menilai laaa game kebelakang strucik main gimana	negative
huda lihat pertandingan engga ngomentarin sesuai permainan	negative
hmm	negative
level timor leste ngomong level asia shintayung shintayung ngomng gede hasil buruk	negative
formasi rada serius napa ngapain turunin	negative
offside kalo kena kaki bang pas umpan posisinya onside pas disentuh emang offside sayang ny kena kaki pemain irak	negative
kritikan bang	positive
knpaaa sandy walsh fi mainkan	neutral
adinda bedain back pass passing operan passing paham sepak bola lawak gini komenlu	neutral
pemain liga lokal main langsung keliatan lemahnya permainan	negative
offside wasit trs gunanya var gtu	neutral
bang ad babak doa aja moga tahan imbang aja harapan fans mah	positive
rafael struick goblok anjeng banyakan gocek main cepet kntol	negative
penyerangannya buntu mulu	negative
bacot dah main gantiin pemain hidup terusan ngejudge main bang bacot trs kerjaan kocak	negative
bener tenang	positive
asnawi anak kesayangan kasihan sandy mending ganti pelatih belanda	neutral
bapuk strike	positive
adinda waras dikit yasudahlah la ikutin ajaa kedepannya gimana	negative
rilll cokk masukin sandy	negative
fr tong negara	neutral
nda malu komenmu tuu	negative
bagaskara iyh hrusnya offside mna nyundul diem dstu	neutral
lord rafael jordi kuciin kmr mandi	neutral
indonesia patut diapresiasi lumbung pangan lumbung goal piala asia	positive
go january welcome park hang seo coach national team indonesia asian cup	positive
bacot mah	negative
asnawi jordi depannya rafael sm marcel sumpah banyakan gocak gocek nda ujung lepas bola tim buntung lawan untung coba belajar yance gocek berfaedah mengerti gocek umpan	negative
rizky ridho gblok passing salah blunder goal gara gara	neutral
offside cok	negative
tombol wasit buta map	negative
jngn ngeras la kirain sblm sundulan	negative
gantinen yusril	neutral
kebobolan lek	negative
kira² wasitnya rabun silinder	negative
rafael struick ngaapa²in	negative
iyaa co wasit var lihat kali	neutral
ayo lahhh	positive
mending struick change sandy wals posisi sandy cocok striker	neutral
blokk	negative
need midfield	negative
penonton harap tenangberi semangat lahjangan komen sampah	neutral
timnas bermain indah tidakpapa semangat garuda muda	positive
goal iraq ko dihitung offside si var gmna	neutral
panikan gesss	negative
tolong striker indonesia ganti	neutral
mending asnawi ganti dah jelek banget mainnya payah club korea kalo impact apabagus klok kapten udah mateng pengalaman dapet control temen emosi jarang pelanggaran	negative
ojok kakean gocek lee satset	negative
baggot ganti lahh	neutral
berani tendang gawang peluang tdk dimanfaatkan	negative
cosplay messi bang taru dilirik club eropa	neutral
semangat pertandingan tersisa kalah hehehee	positive
kalo cek var golnya offside bang kalo lihat golnya sah sah	neutral
bola dibawah kebelakang asnawi sembuh starter lawak mainyamarselino bagusrafael jan egois dongcome garuda bisaa yukkk	neutral
vietnam lawan jelang pakai lapis main bagus main tertata hmm tc makah grasak grusuk higigi	positive
rill cuy	neutral
offside kaya ronaldo nani	negative
klok kunciin	negative
fokussssss	positive
sananta maenin	positive
asnawi grusa grusu	neutral
sty	positive
mari pulang mari pulang	neutral
gila gila kalah teroooosss	positive
mass	positive
trust nadeo shane elkan ridho sandy hubner jordyklok jenner marcelino yacob sanantha know languages connect thats need native speakers every position	neutral
semangat timnas dengerin omongan sok bener	negative
offset	negative
mainkan sananta rafael blunder mulu tolol	negative
luh ge main kntl	negative
woyyy wasitt	negative
opsed bang pemain irak tergeletak didepan gawang ernando opsed	neutral
ghziii afc cup	neutral
minim taktik	neutral
sandy	positive
pokoknya intinya offside bang kocak wasitnya	positive
ayolah sty sandy walsh asnawi	neutral
hasil dukung timnas	positive
sandy walsh dimainin emang anehh	negative
offside bang	negative
apik gul e semangattt ges	positive
marselino asnawi main marselino terlepas goal permainannya kebanyakan gocet ujunga gampang rebut musuh goal irak kesalahan bawa bola oh si rafael egois eyy masukin witan bagus	negative
rafael blm mateng fw thn fw skrg kasih dimassananta	neutral
ayo gapapa menang jugaa kalah kalo kalah tetep gapapa si kebantai semangat	positive
kon kontribusine opo sek	neutral
rafael perform	neutral
offside bangke sahin var	neutral
sandy mainkan woyy	neutral
tolong mainkan sandy coach apapun sandy mainnnya menit menit pertandingan adil indonesia pertandingan menit main menit sandy menit asnawi biar adil bermain ngini gimana netizen kesel coach sandy mainnya bentar banget sedangakan asnawi dehh netizen butuh sandy kasih bermian coach match samgat adil sandy kali match sandy jarang mainnnnn bersemangatttttt membela timnassss	positive
offside bang pas nyundul save ernando bet	neutral
ovwe var lihat	neutral
semangat	positive
dahlah berharap	negative
fans emg agree si main muter muter	neutral
apresiasi timnas trimkasih sdh berjuang goal iraq kontroversi offside semngat timnas	positive
kontribusi negara diem nonton	negative
kak tenang dsni	neutral
ngegolin	negative
marselino taruh tengahh hubner taruh diposisi jordii ajaa	neutral
goal kayanya offside sihhh	negative
ofsaide jnck	negative
rizko ridho mainmu maleh kyk putri solo	negative
hahahaha	positive
kenak keliatan berpengalaman tenang	positive
kalah jngan kasih tekanan hujatan pemain timnas support semangatin semoga lawan vietnam indonesia raih poin bnyak situ mustahil allah	positive
diganti kayak pemain	negative
klok asli bapuk manget main	negative
ayo timnas indonesia fokus babak semoga mencetak goal balasan	neutral
kalah menang bangga timnas bravo	positive
capek lihat permainan mark klok kyk main tarkam	negative
live	neutral
f offside gimana dah wasitnya	negative
terkena kaki duluan ofside	positive
strujick	positive
smart fangirl kebiasaan bat kl pemain jelek dikit lgsng dsrh wkwkwkwkwkwkwkwkw	negative
harapan please dimainkan witan tatktik strategi berjalan	neutral
rafael struick ayo bola rekannya tim	neutral
heading bang	positive
nice try	negative
bilangin sty cpt	negative
jelasin offside	negative
witan dimasukin parahharusnya sandy walsh yng masuksebenarnya bagusan sadil witantpi dicoret	negative
terima kasih semuaa biasaaa im always proud guys	positive
si asnawi beban tim piala asia next cadangan mainkan	neutral
realita nyaaa si struick sebagus gimana bang	positive
tendensi starting lineup cuman disiplin cuman fisik fisik korut dah menang piala dunia	negative
kukira kemarin uji coba pakai mode samaran eh taunya event mainya awur awuran	negative
please struick jan starting line	positive
emosi banget nonton nyaa hehehe	negative
bct	positive
aaditya sepatu mancing	neutral
dipakeee	negative
offside bang kbali var	neutral
kayaknya skor	negative
gmn sdh jatuh bangun mainnya apresiasi	positive
please hurry hamedan msinulingga	positive
streaming cari twitter hd banget	negative
sdm rendah berani bacot pakai akun fake	negative
berap skornya jujurrr takhuttt nonton	positive
dog	negative
yok fight yo babak indonesia	positive
naturalisasi fc	neutral
goal iraq offside var hmm	neutral
miris lihat komen netizen indonesia kebanyakan hujatan muluu hargai pemain pemain drop mental nyaa gara komen kritik kecewa berikanlah kritikan membangun merendahkan	negative
rafeal ganti sananta bola rakuss bola malas kejarr	neutral
alhamdulillah kalah	negative
cukk sumpah cukk indonesia segi permainan kalah fisik lengket bola kaki anjjj	negative
sebenernya offiside goal irak	negative
lo main gmna	neutral
gantiin sono	neutral
halftime fulltime feed yak	positive
idih	positive
woiii ernando temanteman loe berjuang mencetak golloe kalo ernando modelannya kayak ganti kiper	negative
gosah heran bro anak emas emang main	negative
bangg gimna jelasinnya posisi offside ps sentuhan pemain irak kalo emang offside	negative
admin lelet panfage independent	neutral
pasang struick starter blm	neutral
marss half time pakai goal	neutral
yok comeback	positive
asnawi kentol gabisa nyundul bola kepala doang gede anjeng	negative
plis jang dikit ngehujat	negative
aaaa kasian aaa	negative
alhamdulillah gooolllllll	positive
admin ngapain	negative
kalo dukung diemnetizen suka cari kesalahan orang hidupnya kaya bener duniaberjuang negara ngebacot nomer menjijikan	negative
kecewa keegoisan rafael performa marselino keliatan show peluang kehilangan bola seandainya goal haram iraq disahkan sandy walsh cepat dimasukan skor imbang saran next match sifat egois buang kunci kemenangan bermain kerjasama tim	negative
rcti bala iklan	negative
stop hate coment gini nih kebiasaaan netizen indonesia suka hate komen hate komen kontribusinya negaraemang musuh terbesar timnas negara	positive
timnas indonesia kuat allah maha kuat dibabak	positive
kocak kocak	negative
masbro el pleset skg julukannya	neutral
kalah menurutku indonesia mainnya pertandingan semangat garudaku terimakasih keras ngasih terbaik	positive
intinya chemistry berpengaruh timnas indonesia membawa skuad kualifikasi piala asia sentuhan cepat ala timnas korea jalan buktinya yakob sayuri pemain sprinter lari cepat didepan cepat larinya irfan jaya struik berat chemistry dibangun minimal tc chemistry langsung padu perombakan pas kualifikasi piala asia krna pemain keturunan timnas indonesia pemain keturunan pertahanan kuat sayap timnas indonesia pelari cepat gaya main asia timur japan korea tenggara vietnam	positive
nunggu sandy	positive
grasak grusuk bang	positive
wasitttnya kebanyakan lihat liga wakanda sihh	negative
realistis dr rangking langit bumi alhamdulillah kemajuan kmren kalah skrng dpertemuan kualifikasi pildun imbang heheee	negative
pelatih online ribet sty taru kebutuhan tim tinggal bantu doa ribet	neutral
kesini ngasih taru cokkayoo semngattt garuda indonesiaaa	positive
udah gregett gituu kemarin² wajarin friendly match la udah	negative
marss maunya menang gaada support apapunmalah hujat	negative
firaun yass berekspektasi taru puluhan indonesia gapernah lolos kualifikasi piala asia ditangan sty indonesia dg pemain muda² disitu netizen berpikir perkembangan indonesia mantap nikmatin pertandingan proses yakan menang bangga kalah dukung garuda	positive
tombol comeback	positive
aduh tinggal detik udah	negative
asnasi berat awak	negative
bangkit pertandingan bikin malu indonesia	negative
pilih kapten naikin semangat	positive
loo nonton pora suu	positive
jangab tolol lahkalo sty gagal kasih kritik anj	negative
